"filename", "language", "HTML", "Markdown", "XML", "JavaScript", "CSS", "comment", "blank", "total"
"c:\Users\OlabayoBalogun\Documents\GitHub\AfroTada new website code\BotswanaUniversities.html", "HTML", 75, 0, 0, 0, 0, 8, 2, 85
"c:\Users\OlabayoBalogun\Documents\GitHub\AfroTada new website code\KenyaQuotes.html", "HTML", 75, 0, 0, 0, 0, 8, 2, 85
"c:\Users\OlabayoBalogun\Documents\GitHub\AfroTada new website code\MauritaniaPodcasts.html", "HTML", 75, 0, 0, 0, 0, 8, 2, 85
"c:\Users\OlabayoBalogun\Documents\GitHub\AfroTada new website code\README.md", "Markdown", 0, 2, 0, 0, 0, 0, 1, 3
"c:\Users\OlabayoBalogun\Documents\GitHub\AfroTada new website code\SeychellesWriters.html", "HTML", 150, 0, 0, 0, 0, 16, 4, 170
"c:\Users\OlabayoBalogun\Documents\GitHub\AfroTada new website code\aboutUs.html", "HTML", 228, 0, 0, 0, 0, 8, 5, 241
"c:\Users\OlabayoBalogun\Documents\GitHub\AfroTada new website code\africanBooks.html", "HTML", 161, 0, 0, 0, 0, 8, 1, 170
"c:\Users\OlabayoBalogun\Documents\GitHub\AfroTada new website code\africanCulture.html", "HTML", 75, 0, 0, 0, 0, 8, 2, 85
"c:\Users\OlabayoBalogun\Documents\GitHub\AfroTada new website code\africanDocumentaries.html", "HTML", 75, 0, 0, 0, 0, 8, 2, 85
"c:\Users\OlabayoBalogun\Documents\GitHub\AfroTada new website code\africanFood.html", "HTML", 75, 0, 0, 0, 0, 8, 2, 85
"c:\Users\OlabayoBalogun\Documents\GitHub\AfroTada new website code\africanHistoricalSites.html", "HTML", 75, 0, 0, 0, 0, 8, 2, 85
"c:\Users\OlabayoBalogun\Documents\GitHub\AfroTada new website code\africanNaturalResources.html", "HTML", 75, 0, 0, 0, 0, 8, 2, 85
"c:\Users\OlabayoBalogun\Documents\GitHub\AfroTada new website code\africanPodcasts.html", "HTML", 74, 0, 0, 0, 0, 8, 2, 84
"c:\Users\OlabayoBalogun\Documents\GitHub\AfroTada new website code\africanPoets.html", "HTML", 75, 0, 0, 0, 0, 8, 2, 85
"c:\Users\OlabayoBalogun\Documents\GitHub\AfroTada new website code\africanProverbs.html", "HTML", 75, 0, 0, 0, 0, 8, 2, 85
"c:\Users\OlabayoBalogun\Documents\GitHub\AfroTada new website code\africanQuotes.html", "HTML", 75, 0, 0, 0, 0, 8, 2, 85
"c:\Users\OlabayoBalogun\Documents\GitHub\AfroTada new website code\africanUniversities.html", "HTML", 75, 0, 0, 0, 0, 8, 2, 85
"c:\Users\OlabayoBalogun\Documents\GitHub\AfroTada new website code\africanWriters.html", "HTML", 75, 0, 0, 0, 0, 8, 2, 85
"c:\Users\OlabayoBalogun\Documents\GitHub\AfroTada new website code\afrotadaShop.html", "HTML", 75, 0, 0, 0, 0, 8, 1, 84
"c:\Users\OlabayoBalogun\Documents\GitHub\AfroTada new website code\algeria.html", "HTML", 166, 0, 0, 0, 0, 8, 3, 177
"c:\Users\OlabayoBalogun\Documents\GitHub\AfroTada new website code\algerianBooks.html", "HTML", 75, 0, 0, 0, 0, 8, 2, 85
"c:\Users\OlabayoBalogun\Documents\GitHub\AfroTada new website code\algerianCulture.html", "HTML", 75, 0, 0, 0, 0, 8, 2, 85
"c:\Users\OlabayoBalogun\Documents\GitHub\AfroTada new website code\algerianDocumentaries.html", "HTML", 75, 0, 0, 0, 0, 8, 2, 85
"c:\Users\OlabayoBalogun\Documents\GitHub\AfroTada new website code\algerianFood.html", "HTML", 75, 0, 0, 0, 0, 8, 2, 85
"c:\Users\OlabayoBalogun\Documents\GitHub\AfroTada new website code\algerianHistoricalSites.html", "HTML", 75, 0, 0, 0, 0, 8, 2, 85
"c:\Users\OlabayoBalogun\Documents\GitHub\AfroTada new website code\algerianNaturalResources.html", "HTML", 75, 0, 0, 0, 0, 8, 2, 85
"c:\Users\OlabayoBalogun\Documents\GitHub\AfroTada new website code\algerianPodcasts.html", "HTML", 75, 0, 0, 0, 0, 8, 2, 85
"c:\Users\OlabayoBalogun\Documents\GitHub\AfroTada new website code\algerianPoets.html", "HTML", 75, 0, 0, 0, 0, 8, 2, 85
"c:\Users\OlabayoBalogun\Documents\GitHub\AfroTada new website code\algerianProverbs.html", "HTML", 75, 0, 0, 0, 0, 8, 2, 85
"c:\Users\OlabayoBalogun\Documents\GitHub\AfroTada new website code\algerianQuotes.html", "HTML", 75, 0, 0, 0, 0, 8, 2, 85
"c:\Users\OlabayoBalogun\Documents\GitHub\AfroTada new website code\algerianUniversities.html", "HTML", 75, 0, 0, 0, 0, 8, 2, 85
"c:\Users\OlabayoBalogun\Documents\GitHub\AfroTada new website code\algerianWriters.html", "HTML", 75, 0, 0, 0, 0, 8, 2, 85
"c:\Users\OlabayoBalogun\Documents\GitHub\AfroTada new website code\angola.html", "HTML", 164, 0, 0, 0, 0, 8, 3, 175
"c:\Users\OlabayoBalogun\Documents\GitHub\AfroTada new website code\angolanBooks.html", "HTML", 75, 0, 0, 0, 0, 8, 2, 85
"c:\Users\OlabayoBalogun\Documents\GitHub\AfroTada new website code\angolanCulture.html", "HTML", 75, 0, 0, 0, 0, 8, 2, 85
"c:\Users\OlabayoBalogun\Documents\GitHub\AfroTada new website code\angolanDocumentaries.html", "HTML", 75, 0, 0, 0, 0, 8, 2, 85
"c:\Users\OlabayoBalogun\Documents\GitHub\AfroTada new website code\angolanFood.html", "HTML", 75, 0, 0, 0, 0, 8, 2, 85
"c:\Users\OlabayoBalogun\Documents\GitHub\AfroTada new website code\angolanHistoricalSites.html", "HTML", 75, 0, 0, 0, 0, 8, 2, 85
"c:\Users\OlabayoBalogun\Documents\GitHub\AfroTada new website code\angolanNaturalResources.html", "HTML", 76, 0, 0, 0, 0, 8, 2, 86
"c:\Users\OlabayoBalogun\Documents\GitHub\AfroTada new website code\angolanPodcasts.html", "HTML", 75, 0, 0, 0, 0, 8, 2, 85
"c:\Users\OlabayoBalogun\Documents\GitHub\AfroTada new website code\angolanPoets.html", "HTML", 75, 0, 0, 0, 0, 8, 2, 85
"c:\Users\OlabayoBalogun\Documents\GitHub\AfroTada new website code\angolanProverbs.html", "HTML", 75, 0, 0, 0, 0, 8, 2, 85
"c:\Users\OlabayoBalogun\Documents\GitHub\AfroTada new website code\angolanQuotes.html", "HTML", 75, 0, 0, 0, 0, 8, 2, 85
"c:\Users\OlabayoBalogun\Documents\GitHub\AfroTada new website code\angolanUniversities.html", "HTML", 75, 0, 0, 0, 0, 8, 2, 85
"c:\Users\OlabayoBalogun\Documents\GitHub\AfroTada new website code\angolanWriters.html", "HTML", 75, 0, 0, 0, 0, 8, 2, 85
"c:\Users\OlabayoBalogun\Documents\GitHub\AfroTada new website code\benin.html", "HTML", 157, 0, 0, 0, 0, 8, 3, 168
"c:\Users\OlabayoBalogun\Documents\GitHub\AfroTada new website code\beninBooks.html", "HTML", 75, 0, 0, 0, 0, 8, 2, 85
"c:\Users\OlabayoBalogun\Documents\GitHub\AfroTada new website code\beninCulture.html", "HTML", 76, 0, 0, 0, 0, 8, 2, 86
"c:\Users\OlabayoBalogun\Documents\GitHub\AfroTada new website code\beninDocumentaries.html", "HTML", 75, 0, 0, 0, 0, 8, 2, 85
"c:\Users\OlabayoBalogun\Documents\GitHub\AfroTada new website code\beninFood.html", "HTML", 75, 0, 0, 0, 0, 8, 2, 85
"c:\Users\OlabayoBalogun\Documents\GitHub\AfroTada new website code\beninHistoricalSites.html", "HTML", 75, 0, 0, 0, 0, 8, 2, 85
"c:\Users\OlabayoBalogun\Documents\GitHub\AfroTada new website code\beninNaturalResources.html", "HTML", 75, 0, 0, 0, 0, 8, 2, 85
"c:\Users\OlabayoBalogun\Documents\GitHub\AfroTada new website code\beninPodcasts.html", "HTML", 75, 0, 0, 0, 0, 8, 2, 85
"c:\Users\OlabayoBalogun\Documents\GitHub\AfroTada new website code\beninPoets.html", "HTML", 75, 0, 0, 0, 0, 8, 2, 85
"c:\Users\OlabayoBalogun\Documents\GitHub\AfroTada new website code\beninProverbs.html", "HTML", 75, 0, 0, 0, 0, 8, 2, 85
"c:\Users\OlabayoBalogun\Documents\GitHub\AfroTada new website code\beninQuotes.html", "HTML", 75, 0, 0, 0, 0, 8, 2, 85
"c:\Users\OlabayoBalogun\Documents\GitHub\AfroTada new website code\beninUniversities.html", "HTML", 75, 0, 0, 0, 0, 8, 2, 85
"c:\Users\OlabayoBalogun\Documents\GitHub\AfroTada new website code\beninWriters.html", "HTML", 75, 0, 0, 0, 0, 8, 2, 85
"c:\Users\OlabayoBalogun\Documents\GitHub\AfroTada new website code\botswana.html", "HTML", 157, 0, 0, 0, 0, 8, 3, 168
"c:\Users\OlabayoBalogun\Documents\GitHub\AfroTada new website code\botswanaBooks.html", "HTML", 75, 0, 0, 0, 0, 8, 2, 85
"c:\Users\OlabayoBalogun\Documents\GitHub\AfroTada new website code\botswanaCulture.html", "HTML", 75, 0, 0, 0, 0, 8, 2, 85
"c:\Users\OlabayoBalogun\Documents\GitHub\AfroTada new website code\botswanaDocumentaries.html", "HTML", 75, 0, 0, 0, 0, 8, 2, 85
"c:\Users\OlabayoBalogun\Documents\GitHub\AfroTada new website code\botswanaFood.html", "HTML", 75, 0, 0, 0, 0, 8, 2, 85
"c:\Users\OlabayoBalogun\Documents\GitHub\AfroTada new website code\botswanaHistoricalSites.html", "HTML", 75, 0, 0, 0, 0, 8, 2, 85
"c:\Users\OlabayoBalogun\Documents\GitHub\AfroTada new website code\botswanaNaturalResources.html", "HTML", 75, 0, 0, 0, 0, 8, 2, 85
"c:\Users\OlabayoBalogun\Documents\GitHub\AfroTada new website code\botswanaPodcasts.html", "HTML", 75, 0, 0, 0, 0, 8, 2, 85
"c:\Users\OlabayoBalogun\Documents\GitHub\AfroTada new website code\botswanaPoets.html", "HTML", 75, 0, 0, 0, 0, 8, 2, 85
"c:\Users\OlabayoBalogun\Documents\GitHub\AfroTada new website code\botswanaProverbs.html", "HTML", 75, 0, 0, 0, 0, 8, 2, 85
"c:\Users\OlabayoBalogun\Documents\GitHub\AfroTada new website code\botswanaQuotes.html", "HTML", 75, 0, 0, 0, 0, 8, 2, 85
"c:\Users\OlabayoBalogun\Documents\GitHub\AfroTada new website code\botswanaWriters.html", "HTML", 75, 0, 0, 0, 0, 8, 2, 85
"c:\Users\OlabayoBalogun\Documents\GitHub\AfroTada new website code\burkinaFaso.html", "HTML", 157, 0, 0, 0, 0, 8, 3, 168
"c:\Users\OlabayoBalogun\Documents\GitHub\AfroTada new website code\burkinaFasoBooks.html", "HTML", 75, 0, 0, 0, 0, 8, 2, 85
"c:\Users\OlabayoBalogun\Documents\GitHub\AfroTada new website code\burkinaFasoCulture.html", "HTML", 75, 0, 0, 0, 0, 8, 2, 85
"c:\Users\OlabayoBalogun\Documents\GitHub\AfroTada new website code\burkinaFasoDocumentaries.html", "HTML", 75, 0, 0, 0, 0, 8, 2, 85
"c:\Users\OlabayoBalogun\Documents\GitHub\AfroTada new website code\burkinaFasoFood.html", "HTML", 75, 0, 0, 0, 0, 8, 2, 85
"c:\Users\OlabayoBalogun\Documents\GitHub\AfroTada new website code\burkinaFasoHistoricalSites.html", "HTML", 75, 0, 0, 0, 0, 8, 2, 85
"c:\Users\OlabayoBalogun\Documents\GitHub\AfroTada new website code\burkinaFasoNaturalResources.html", "HTML", 75, 0, 0, 0, 0, 8, 2, 85
"c:\Users\OlabayoBalogun\Documents\GitHub\AfroTada new website code\burkinaFasoPodcasts.html", "HTML", 75, 0, 0, 0, 0, 8, 2, 85
"c:\Users\OlabayoBalogun\Documents\GitHub\AfroTada new website code\burkinaFasoPoets.html", "HTML", 75, 0, 0, 0, 0, 8, 2, 85
"c:\Users\OlabayoBalogun\Documents\GitHub\AfroTada new website code\burkinaFasoProverbs.html", "HTML", 75, 0, 0, 0, 0, 8, 2, 85
"c:\Users\OlabayoBalogun\Documents\GitHub\AfroTada new website code\burkinaFasoQuotes.html", "HTML", 75, 0, 0, 0, 0, 8, 2, 85
"c:\Users\OlabayoBalogun\Documents\GitHub\AfroTada new website code\burkinaFasoUniversities.html", "HTML", 75, 0, 0, 0, 0, 8, 2, 85
"c:\Users\OlabayoBalogun\Documents\GitHub\AfroTada new website code\burkinaFasoWriters.html", "HTML", 75, 0, 0, 0, 0, 8, 2, 85
"c:\Users\OlabayoBalogun\Documents\GitHub\AfroTada new website code\burundi.html", "HTML", 157, 0, 0, 0, 0, 8, 3, 168
"c:\Users\OlabayoBalogun\Documents\GitHub\AfroTada new website code\burundiBooks.html", "HTML", 75, 0, 0, 0, 0, 8, 2, 85
"c:\Users\OlabayoBalogun\Documents\GitHub\AfroTada new website code\burundiCulture.html", "HTML", 75, 0, 0, 0, 0, 8, 2, 85
"c:\Users\OlabayoBalogun\Documents\GitHub\AfroTada new website code\burundiDocumentaries.html", "HTML", 75, 0, 0, 0, 0, 8, 2, 85
"c:\Users\OlabayoBalogun\Documents\GitHub\AfroTada new website code\burundiFood.html", "HTML", 75, 0, 0, 0, 0, 8, 2, 85
"c:\Users\OlabayoBalogun\Documents\GitHub\AfroTada new website code\burundiHistoricalSites.html", "HTML", 75, 0, 0, 0, 0, 8, 2, 85
"c:\Users\OlabayoBalogun\Documents\GitHub\AfroTada new website code\burundiNaturalResources.html", "HTML", 75, 0, 0, 0, 0, 8, 2, 85
"c:\Users\OlabayoBalogun\Documents\GitHub\AfroTada new website code\burundiPodcasts.html", "HTML", 75, 0, 0, 0, 0, 8, 2, 85
"c:\Users\OlabayoBalogun\Documents\GitHub\AfroTada new website code\burundiPoets.html", "HTML", 75, 0, 0, 0, 0, 8, 2, 85
"c:\Users\OlabayoBalogun\Documents\GitHub\AfroTada new website code\burundiProverbs.html", "HTML", 75, 0, 0, 0, 0, 8, 2, 85
"c:\Users\OlabayoBalogun\Documents\GitHub\AfroTada new website code\burundiQuotes.html", "HTML", 75, 0, 0, 0, 0, 8, 2, 85
"c:\Users\OlabayoBalogun\Documents\GitHub\AfroTada new website code\burundiUniversities.html", "HTML", 75, 0, 0, 0, 0, 8, 2, 85
"c:\Users\OlabayoBalogun\Documents\GitHub\AfroTada new website code\burundiWriters.html", "HTML", 75, 0, 0, 0, 0, 8, 2, 85
"c:\Users\OlabayoBalogun\Documents\GitHub\AfroTada new website code\cameroon.html", "HTML", 157, 0, 0, 0, 0, 8, 3, 168
"c:\Users\OlabayoBalogun\Documents\GitHub\AfroTada new website code\cameroonBooks.html", "HTML", 75, 0, 0, 0, 0, 8, 2, 85
"c:\Users\OlabayoBalogun\Documents\GitHub\AfroTada new website code\cameroonCulture.html", "HTML", 75, 0, 0, 0, 0, 8, 2, 85
"c:\Users\OlabayoBalogun\Documents\GitHub\AfroTada new website code\cameroonDocumentaries.html", "HTML", 75, 0, 0, 0, 0, 8, 2, 85
"c:\Users\OlabayoBalogun\Documents\GitHub\AfroTada new website code\cameroonFood.html", "HTML", 75, 0, 0, 0, 0, 8, 2, 85
"c:\Users\OlabayoBalogun\Documents\GitHub\AfroTada new website code\cameroonHistoricalSites.html", "HTML", 75, 0, 0, 0, 0, 8, 2, 85
"c:\Users\OlabayoBalogun\Documents\GitHub\AfroTada new website code\cameroonNaturalResources.html", "HTML", 75, 0, 0, 0, 0, 8, 2, 85
"c:\Users\OlabayoBalogun\Documents\GitHub\AfroTada new website code\cameroonPodcasts.html", "HTML", 75, 0, 0, 0, 0, 8, 2, 85
"c:\Users\OlabayoBalogun\Documents\GitHub\AfroTada new website code\cameroonPoets.html", "HTML", 75, 0, 0, 0, 0, 8, 2, 85
"c:\Users\OlabayoBalogun\Documents\GitHub\AfroTada new website code\cameroonProverbs.html", "HTML", 75, 0, 0, 0, 0, 8, 2, 85
"c:\Users\OlabayoBalogun\Documents\GitHub\AfroTada new website code\cameroonQuotes.html", "HTML", 75, 0, 0, 0, 0, 8, 2, 85
"c:\Users\OlabayoBalogun\Documents\GitHub\AfroTada new website code\cameroonUniversities.html", "HTML", 75, 0, 0, 0, 0, 8, 2, 85
"c:\Users\OlabayoBalogun\Documents\GitHub\AfroTada new website code\cameroonWriters.html", "HTML", 75, 0, 0, 0, 0, 8, 2, 85
"c:\Users\OlabayoBalogun\Documents\GitHub\AfroTada new website code\capeVerde.html", "HTML", 157, 0, 0, 0, 0, 8, 3, 168
"c:\Users\OlabayoBalogun\Documents\GitHub\AfroTada new website code\capeVerdeBooks.html", "HTML", 75, 0, 0, 0, 0, 8, 2, 85
"c:\Users\OlabayoBalogun\Documents\GitHub\AfroTada new website code\capeVerdeCulture.html", "HTML", 75, 0, 0, 0, 0, 8, 2, 85
"c:\Users\OlabayoBalogun\Documents\GitHub\AfroTada new website code\capeVerdeDocumentaries.html", "HTML", 75, 0, 0, 0, 0, 8, 2, 85
"c:\Users\OlabayoBalogun\Documents\GitHub\AfroTada new website code\capeVerdeFood.html", "HTML", 75, 0, 0, 0, 0, 8, 2, 85
"c:\Users\OlabayoBalogun\Documents\GitHub\AfroTada new website code\capeVerdeHistoricalSites.html", "HTML", 75, 0, 0, 0, 0, 8, 2, 85
"c:\Users\OlabayoBalogun\Documents\GitHub\AfroTada new website code\capeVerdeNaturalResources.html", "HTML", 75, 0, 0, 0, 0, 8, 2, 85
"c:\Users\OlabayoBalogun\Documents\GitHub\AfroTada new website code\capeVerdePodcasts.html", "HTML", 75, 0, 0, 0, 0, 8, 2, 85
"c:\Users\OlabayoBalogun\Documents\GitHub\AfroTada new website code\capeVerdePoets.html", "HTML", 75, 0, 0, 0, 0, 8, 2, 85
"c:\Users\OlabayoBalogun\Documents\GitHub\AfroTada new website code\capeVerdeProverbs.html", "HTML", 75, 0, 0, 0, 0, 8, 2, 85
"c:\Users\OlabayoBalogun\Documents\GitHub\AfroTada new website code\capeVerdeQuotes.html", "HTML", 75, 0, 0, 0, 0, 8, 2, 85
"c:\Users\OlabayoBalogun\Documents\GitHub\AfroTada new website code\capeVerdeUniversities.html", "HTML", 75, 0, 0, 0, 0, 8, 2, 85
"c:\Users\OlabayoBalogun\Documents\GitHub\AfroTada new website code\capeVerdeWriters.html", "HTML", 75, 0, 0, 0, 0, 8, 2, 85
"c:\Users\OlabayoBalogun\Documents\GitHub\AfroTada new website code\centralAfricanRepublic.html", "HTML", 157, 0, 0, 0, 0, 8, 3, 168
"c:\Users\OlabayoBalogun\Documents\GitHub\AfroTada new website code\centralAfricanRepublicBooks.html", "HTML", 75, 0, 0, 0, 0, 8, 2, 85
"c:\Users\OlabayoBalogun\Documents\GitHub\AfroTada new website code\centralAfricanRepublicCulture.html", "HTML", 75, 0, 0, 0, 0, 8, 2, 85
"c:\Users\OlabayoBalogun\Documents\GitHub\AfroTada new website code\centralAfricanRepublicDocumentaries.html", "HTML", 75, 0, 0, 0, 0, 8, 2, 85
"c:\Users\OlabayoBalogun\Documents\GitHub\AfroTada new website code\centralAfricanRepublicFood.html", "HTML", 75, 0, 0, 0, 0, 8, 2, 85
"c:\Users\OlabayoBalogun\Documents\GitHub\AfroTada new website code\centralAfricanRepublicHistoricalSites.html", "HTML", 75, 0, 0, 0, 0, 8, 2, 85
"c:\Users\OlabayoBalogun\Documents\GitHub\AfroTada new website code\centralAfricanRepublicNaturalResources.html", "HTML", 75, 0, 0, 0, 0, 8, 2, 85
"c:\Users\OlabayoBalogun\Documents\GitHub\AfroTada new website code\centralAfricanRepublicPodcasts.html", "HTML", 82, 0, 0, 0, 0, 6, 3, 91
"c:\Users\OlabayoBalogun\Documents\GitHub\AfroTada new website code\centralAfricanRepublicPoets.html", "HTML", 75, 0, 0, 0, 0, 8, 2, 85
"c:\Users\OlabayoBalogun\Documents\GitHub\AfroTada new website code\centralAfricanRepublicProverbs.html", "HTML", 75, 0, 0, 0, 0, 8, 2, 85
"c:\Users\OlabayoBalogun\Documents\GitHub\AfroTada new website code\centralAfricanRepublicQuotes.html", "HTML", 75, 0, 0, 0, 0, 8, 2, 85
"c:\Users\OlabayoBalogun\Documents\GitHub\AfroTada new website code\centralAfricanRepublicUniversities.html", "HTML", 75, 0, 0, 0, 0, 8, 2, 85
"c:\Users\OlabayoBalogun\Documents\GitHub\AfroTada new website code\centralAfricanRepublicWriters.html", "HTML", 75, 0, 0, 0, 0, 8, 2, 85
"c:\Users\OlabayoBalogun\Documents\GitHub\AfroTada new website code\chad.html", "HTML", 157, 0, 0, 0, 0, 8, 3, 168
"c:\Users\OlabayoBalogun\Documents\GitHub\AfroTada new website code\chadBooks.html", "HTML", 75, 0, 0, 0, 0, 8, 2, 85
"c:\Users\OlabayoBalogun\Documents\GitHub\AfroTada new website code\chadCulture.html", "HTML", 75, 0, 0, 0, 0, 8, 2, 85
"c:\Users\OlabayoBalogun\Documents\GitHub\AfroTada new website code\chadDocumentaries.html", "HTML", 75, 0, 0, 0, 0, 8, 2, 85
"c:\Users\OlabayoBalogun\Documents\GitHub\AfroTada new website code\chadFood.html", "HTML", 75, 0, 0, 0, 0, 8, 2, 85
"c:\Users\OlabayoBalogun\Documents\GitHub\AfroTada new website code\chadHistoricalSites.html", "HTML", 75, 0, 0, 0, 0, 8, 2, 85
"c:\Users\OlabayoBalogun\Documents\GitHub\AfroTada new website code\chadNaturalResources.html", "HTML", 75, 0, 0, 0, 0, 8, 2, 85
"c:\Users\OlabayoBalogun\Documents\GitHub\AfroTada new website code\chadPodcasts.html", "HTML", 75, 0, 0, 0, 0, 8, 2, 85
"c:\Users\OlabayoBalogun\Documents\GitHub\AfroTada new website code\chadPoets.html", "HTML", 75, 0, 0, 0, 0, 8, 2, 85
"c:\Users\OlabayoBalogun\Documents\GitHub\AfroTada new website code\chadProverbs.html", "HTML", 75, 0, 0, 0, 0, 8, 2, 85
"c:\Users\OlabayoBalogun\Documents\GitHub\AfroTada new website code\chadQuotes.html", "HTML", 75, 0, 0, 0, 0, 8, 2, 85
"c:\Users\OlabayoBalogun\Documents\GitHub\AfroTada new website code\chadUniversities.html", "HTML", 75, 0, 0, 0, 0, 8, 2, 85
"c:\Users\OlabayoBalogun\Documents\GitHub\AfroTada new website code\chadWriters.html", "HTML", 75, 0, 0, 0, 0, 8, 2, 85
"c:\Users\OlabayoBalogun\Documents\GitHub\AfroTada new website code\comoros.html", "HTML", 157, 0, 0, 0, 0, 8, 3, 168
"c:\Users\OlabayoBalogun\Documents\GitHub\AfroTada new website code\comorosBooks.html", "HTML", 75, 0, 0, 0, 0, 8, 2, 85
"c:\Users\OlabayoBalogun\Documents\GitHub\AfroTada new website code\comorosCulture.html", "HTML", 75, 0, 0, 0, 0, 8, 2, 85
"c:\Users\OlabayoBalogun\Documents\GitHub\AfroTada new website code\comorosDocumentaries.html", "HTML", 75, 0, 0, 0, 0, 8, 2, 85
"c:\Users\OlabayoBalogun\Documents\GitHub\AfroTada new website code\comorosFood.html", "HTML", 75, 0, 0, 0, 0, 8, 2, 85
"c:\Users\OlabayoBalogun\Documents\GitHub\AfroTada new website code\comorosHistoricalSites.html", "HTML", 76, 0, 0, 0, 0, 8, 2, 86
"c:\Users\OlabayoBalogun\Documents\GitHub\AfroTada new website code\comorosNaturalResources.html", "HTML", 75, 0, 0, 0, 0, 8, 2, 85
"c:\Users\OlabayoBalogun\Documents\GitHub\AfroTada new website code\comorosPodcasts.html", "HTML", 75, 0, 0, 0, 0, 8, 2, 85
"c:\Users\OlabayoBalogun\Documents\GitHub\AfroTada new website code\comorosPoets.html", "HTML", 75, 0, 0, 0, 0, 8, 2, 85
"c:\Users\OlabayoBalogun\Documents\GitHub\AfroTada new website code\comorosProverbs.html", "HTML", 75, 0, 0, 0, 0, 8, 2, 85
"c:\Users\OlabayoBalogun\Documents\GitHub\AfroTada new website code\comorosQuotes.html", "HTML", 75, 0, 0, 0, 0, 8, 2, 85
"c:\Users\OlabayoBalogun\Documents\GitHub\AfroTada new website code\comorosUniversities.html", "HTML", 75, 0, 0, 0, 0, 8, 2, 85
"c:\Users\OlabayoBalogun\Documents\GitHub\AfroTada new website code\comorosWriters.html", "HTML", 76, 0, 0, 0, 0, 8, 2, 86
"c:\Users\OlabayoBalogun\Documents\GitHub\AfroTada new website code\contactUs.html", "HTML", 97, 0, 0, 0, 0, 8, 5, 110
"c:\Users\OlabayoBalogun\Documents\GitHub\AfroTada new website code\cookiePolicy.html", "HTML", 124, 0, 0, 0, 0, 8, 18, 150
"c:\Users\OlabayoBalogun\Documents\GitHub\AfroTada new website code\cotedivoire.html", "HTML", 157, 0, 0, 0, 0, 8, 3, 168
"c:\Users\OlabayoBalogun\Documents\GitHub\AfroTada new website code\cotedivoireBooks.html", "HTML", 75, 0, 0, 0, 0, 8, 2, 85
"c:\Users\OlabayoBalogun\Documents\GitHub\AfroTada new website code\cotedivoireCulture.html", "HTML", 75, 0, 0, 0, 0, 8, 2, 85
"c:\Users\OlabayoBalogun\Documents\GitHub\AfroTada new website code\cotedivoireDocumentaries.html", "HTML", 75, 0, 0, 0, 0, 8, 3, 86
"c:\Users\OlabayoBalogun\Documents\GitHub\AfroTada new website code\cotedivoireFood.html", "HTML", 75, 0, 0, 0, 0, 8, 2, 85
"c:\Users\OlabayoBalogun\Documents\GitHub\AfroTada new website code\cotedivoireHistoricalSites.html", "HTML", 75, 0, 0, 0, 0, 8, 2, 85
"c:\Users\OlabayoBalogun\Documents\GitHub\AfroTada new website code\cotedivoireNaturalResources.html", "HTML", 75, 0, 0, 0, 0, 8, 2, 85
"c:\Users\OlabayoBalogun\Documents\GitHub\AfroTada new website code\cotedivoirePodcasts.html", "HTML", 75, 0, 0, 0, 0, 8, 2, 85
"c:\Users\OlabayoBalogun\Documents\GitHub\AfroTada new website code\cotedivoirePoets.html", "HTML", 75, 0, 0, 0, 0, 8, 2, 85
"c:\Users\OlabayoBalogun\Documents\GitHub\AfroTada new website code\cotedivoireProverbs.html", "HTML", 75, 0, 0, 0, 0, 8, 2, 85
"c:\Users\OlabayoBalogun\Documents\GitHub\AfroTada new website code\cotedivoireQuotes.html", "HTML", 75, 0, 0, 0, 0, 8, 2, 85
"c:\Users\OlabayoBalogun\Documents\GitHub\AfroTada new website code\cotedivoireUniversities.html", "HTML", 75, 0, 0, 0, 0, 8, 2, 85
"c:\Users\OlabayoBalogun\Documents\GitHub\AfroTada new website code\cotedivoireWriters.html", "HTML", 75, 0, 0, 0, 0, 8, 2, 85
"c:\Users\OlabayoBalogun\Documents\GitHub\AfroTada new website code\css\aboutUs.css", "CSS", 0, 0, 0, 0, 529, 28, 105, 662
"c:\Users\OlabayoBalogun\Documents\GitHub\AfroTada new website code\css\africanBooks.css", "CSS", 0, 0, 0, 0, 410, 26, 83, 519
"c:\Users\OlabayoBalogun\Documents\GitHub\AfroTada new website code\css\africanCulture.css", "CSS", 0, 0, 0, 0, 318, 26, 66, 410
"c:\Users\OlabayoBalogun\Documents\GitHub\AfroTada new website code\css\africanDocumentaries.css", "CSS", 0, 0, 0, 0, 318, 26, 66, 410
"c:\Users\OlabayoBalogun\Documents\GitHub\AfroTada new website code\css\africanFood.css", "CSS", 0, 0, 0, 0, 318, 26, 66, 410
"c:\Users\OlabayoBalogun\Documents\GitHub\AfroTada new website code\css\africanHistoricalSites.css", "CSS", 0, 0, 0, 0, 319, 25, 65, 409
"c:\Users\OlabayoBalogun\Documents\GitHub\AfroTada new website code\css\africanNaturalResources.css", "CSS", 0, 0, 0, 0, 326, 26, 70, 422
"c:\Users\OlabayoBalogun\Documents\GitHub\AfroTada new website code\css\africanPodcasts.css", "CSS", 0, 0, 0, 0, 318, 26, 66, 410
"c:\Users\OlabayoBalogun\Documents\GitHub\AfroTada new website code\css\africanPoets.css", "CSS", 0, 0, 0, 0, 318, 26, 66, 410
"c:\Users\OlabayoBalogun\Documents\GitHub\AfroTada new website code\css\africanProverbs.css", "CSS", 0, 0, 0, 0, 318, 26, 66, 410
"c:\Users\OlabayoBalogun\Documents\GitHub\AfroTada new website code\css\africanQuotes.css", "CSS", 0, 0, 0, 0, 318, 26, 66, 410
"c:\Users\OlabayoBalogun\Documents\GitHub\AfroTada new website code\css\africanUniversities.css", "CSS", 0, 0, 0, 0, 318, 26, 66, 410
"c:\Users\OlabayoBalogun\Documents\GitHub\AfroTada new website code\css\africanWriters.css", "CSS", 0, 0, 0, 0, 318, 26, 66, 410
"c:\Users\OlabayoBalogun\Documents\GitHub\AfroTada new website code\css\afrotadaShop.css", "CSS", 0, 0, 0, 0, 314, 26, 65, 405
"c:\Users\OlabayoBalogun\Documents\GitHub\AfroTada new website code\css\algeria.css", "CSS", 0, 0, 0, 0, 551, 26, 122, 699
"c:\Users\OlabayoBalogun\Documents\GitHub\AfroTada new website code\css\angola.css", "CSS", 0, 0, 0, 0, 551, 26, 121, 698
"c:\Users\OlabayoBalogun\Documents\GitHub\AfroTada new website code\css\angolanNaturalResources.css", "CSS", 0, 0, 0, 0, 335, 26, 76, 437
"c:\Users\OlabayoBalogun\Documents\GitHub\AfroTada new website code\css\benin.css", "CSS", 0, 0, 0, 0, 551, 26, 121, 698
"c:\Users\OlabayoBalogun\Documents\GitHub\AfroTada new website code\css\botswana.css", "CSS", 0, 0, 0, 0, 551, 26, 121, 698
"c:\Users\OlabayoBalogun\Documents\GitHub\AfroTada new website code\css\burkinaFaso.css", "CSS", 0, 0, 0, 0, 551, 26, 121, 698
"c:\Users\OlabayoBalogun\Documents\GitHub\AfroTada new website code\css\burundi.css", "CSS", 0, 0, 0, 0, 551, 26, 121, 698
"c:\Users\OlabayoBalogun\Documents\GitHub\AfroTada new website code\css\cameroon.css", "CSS", 0, 0, 0, 0, 551, 26, 121, 698
"c:\Users\OlabayoBalogun\Documents\GitHub\AfroTada new website code\css\capeVerde.css", "CSS", 0, 0, 0, 0, 551, 26, 121, 698
"c:\Users\OlabayoBalogun\Documents\GitHub\AfroTada new website code\css\centralAfricanRepublic.css", "CSS", 0, 0, 0, 0, 551, 26, 121, 698
"c:\Users\OlabayoBalogun\Documents\GitHub\AfroTada new website code\css\chad.css", "CSS", 0, 0, 0, 0, 551, 26, 121, 698
"c:\Users\OlabayoBalogun\Documents\GitHub\AfroTada new website code\css\comingSoon.css", "CSS", 0, 0, 0, 0, 380, 26, 80, 486
"c:\Users\OlabayoBalogun\Documents\GitHub\AfroTada new website code\css\comoros.css", "CSS", 0, 0, 0, 0, 551, 26, 121, 698
"c:\Users\OlabayoBalogun\Documents\GitHub\AfroTada new website code\css\contactUs.css", "CSS", 0, 0, 0, 0, 435, 26, 83, 544
"c:\Users\OlabayoBalogun\Documents\GitHub\AfroTada new website code\css\cookiePolicy.css", "CSS", 0, 0, 0, 0, 341, 26, 68, 435
"c:\Users\OlabayoBalogun\Documents\GitHub\AfroTada new website code\css\cotedivoire.css", "CSS", 0, 0, 0, 0, 551, 26, 121, 698
"c:\Users\OlabayoBalogun\Documents\GitHub\AfroTada new website code\css\djibouti.css", "CSS", 0, 0, 0, 0, 551, 26, 121, 698
"c:\Users\OlabayoBalogun\Documents\GitHub\AfroTada new website code\css\drCongo.css", "CSS", 0, 0, 0, 0, 551, 26, 121, 698
"c:\Users\OlabayoBalogun\Documents\GitHub\AfroTada new website code\css\egypt.css", "CSS", 0, 0, 0, 0, 551, 26, 121, 698
"c:\Users\OlabayoBalogun\Documents\GitHub\AfroTada new website code\css\equatorialGuinea.css", "CSS", 0, 0, 0, 0, 551, 26, 121, 698
"c:\Users\OlabayoBalogun\Documents\GitHub\AfroTada new website code\css\eritrea.css", "CSS", 0, 0, 0, 0, 432, 30, 92, 554
"c:\Users\OlabayoBalogun\Documents\GitHub\AfroTada new website code\css\eswatini.css", "CSS", 0, 0, 0, 0, 551, 26, 121, 698
"c:\Users\OlabayoBalogun\Documents\GitHub\AfroTada new website code\css\ethiopia.css", "CSS", 0, 0, 0, 0, 551, 26, 122, 699
"c:\Users\OlabayoBalogun\Documents\GitHub\AfroTada new website code\css\gabon.css", "CSS", 0, 0, 0, 0, 551, 26, 121, 698
"c:\Users\OlabayoBalogun\Documents\GitHub\AfroTada new website code\css\gambia.css", "CSS", 0, 0, 0, 0, 551, 26, 121, 698
"c:\Users\OlabayoBalogun\Documents\GitHub\AfroTada new website code\css\ghana.css", "CSS", 0, 0, 0, 0, 551, 26, 121, 698
"c:\Users\OlabayoBalogun\Documents\GitHub\AfroTada new website code\css\guinea.css", "CSS", 0, 0, 0, 0, 551, 26, 121, 698
"c:\Users\OlabayoBalogun\Documents\GitHub\AfroTada new website code\css\guineaBissau.css", "CSS", 0, 0, 0, 0, 551, 26, 121, 698
"c:\Users\OlabayoBalogun\Documents\GitHub\AfroTada new website code\css\homepage.css", "CSS", 0, 0, 0, 0, 706, 24, 160, 890
"c:\Users\OlabayoBalogun\Documents\GitHub\AfroTada new website code\css\kenya.css", "CSS", 0, 0, 0, 0, 551, 26, 121, 698
"c:\Users\OlabayoBalogun\Documents\GitHub\AfroTada new website code\css\lesotho.css", "CSS", 0, 0, 0, 0, 551, 26, 121, 698
"c:\Users\OlabayoBalogun\Documents\GitHub\AfroTada new website code\css\liberia.css", "CSS", 0, 0, 0, 0, 551, 26, 121, 698
"c:\Users\OlabayoBalogun\Documents\GitHub\AfroTada new website code\css\libya.css", "CSS", 0, 0, 0, 0, 551, 26, 121, 698
"c:\Users\OlabayoBalogun\Documents\GitHub\AfroTada new website code\css\madagascar.css", "CSS", 0, 0, 0, 0, 551, 26, 121, 698
"c:\Users\OlabayoBalogun\Documents\GitHub\AfroTada new website code\css\malawi.css", "CSS", 0, 0, 0, 0, 551, 26, 121, 698
"c:\Users\OlabayoBalogun\Documents\GitHub\AfroTada new website code\css\mali.css", "CSS", 0, 0, 0, 0, 551, 26, 121, 698
"c:\Users\OlabayoBalogun\Documents\GitHub\AfroTada new website code\css\mauritania.css", "CSS", 0, 0, 0, 0, 551, 26, 121, 698
"c:\Users\OlabayoBalogun\Documents\GitHub\AfroTada new website code\css\mauritius.css", "CSS", 0, 0, 0, 0, 551, 26, 121, 698
"c:\Users\OlabayoBalogun\Documents\GitHub\AfroTada new website code\css\morocco.css", "CSS", 0, 0, 0, 0, 551, 26, 121, 698
"c:\Users\OlabayoBalogun\Documents\GitHub\AfroTada new website code\css\mozambique.css", "CSS", 0, 0, 0, 0, 551, 26, 121, 698
"c:\Users\OlabayoBalogun\Documents\GitHub\AfroTada new website code\css\namibia.css", "CSS", 0, 0, 0, 0, 551, 26, 121, 698
"c:\Users\OlabayoBalogun\Documents\GitHub\AfroTada new website code\css\niger.css", "CSS", 0, 0, 0, 0, 551, 26, 121, 698
"c:\Users\OlabayoBalogun\Documents\GitHub\AfroTada new website code\css\nigeria.css", "CSS", 0, 0, 0, 0, 551, 26, 121, 698
"c:\Users\OlabayoBalogun\Documents\GitHub\AfroTada new website code\css\nigerianBooks.css", "CSS", 0, 0, 0, 0, 410, 26, 83, 519
"c:\Users\OlabayoBalogun\Documents\GitHub\AfroTada new website code\css\privacyPolicy.css", "CSS", 0, 0, 0, 0, 396, 26, 80, 502
"c:\Users\OlabayoBalogun\Documents\GitHub\AfroTada new website code\css\republicOfCongo.css", "CSS", 0, 0, 0, 0, 551, 26, 121, 698
"c:\Users\OlabayoBalogun\Documents\GitHub\AfroTada new website code\css\resources.css", "CSS", 0, 0, 0, 0, 552, 26, 121, 699
"c:\Users\OlabayoBalogun\Documents\GitHub\AfroTada new website code\css\resourcesByCountry.css", "CSS", 0, 0, 0, 0, 259, 26, 65, 350
"c:\Users\OlabayoBalogun\Documents\GitHub\AfroTada new website code\css\rwanda.css", "CSS", 0, 0, 0, 0, 551, 26, 121, 698
"c:\Users\OlabayoBalogun\Documents\GitHub\AfroTada new website code\css\saoTomeAndPrincipe.css", "CSS", 0, 0, 0, 0, 551, 26, 121, 698
"c:\Users\OlabayoBalogun\Documents\GitHub\AfroTada new website code\css\senegal.css", "CSS", 0, 0, 0, 0, 551, 26, 121, 698
"c:\Users\OlabayoBalogun\Documents\GitHub\AfroTada new website code\css\seychelles.css", "CSS", 0, 0, 0, 0, 551, 26, 121, 698
"c:\Users\OlabayoBalogun\Documents\GitHub\AfroTada new website code\css\sierraLeone.css", "CSS", 0, 0, 0, 0, 551, 26, 121, 698
"c:\Users\OlabayoBalogun\Documents\GitHub\AfroTada new website code\css\somalia.css", "CSS", 0, 0, 0, 0, 551, 26, 121, 698
"c:\Users\OlabayoBalogun\Documents\GitHub\AfroTada new website code\css\southAfrica.css", "CSS", 0, 0, 0, 0, 551, 26, 121, 698
"c:\Users\OlabayoBalogun\Documents\GitHub\AfroTada new website code\css\southSudan.css", "CSS", 0, 0, 0, 0, 551, 26, 121, 698
"c:\Users\OlabayoBalogun\Documents\GitHub\AfroTada new website code\css\sudan.css", "CSS", 0, 0, 0, 0, 551, 26, 121, 698
"c:\Users\OlabayoBalogun\Documents\GitHub\AfroTada new website code\css\tanzania.css", "CSS", 0, 0, 0, 0, 551, 26, 121, 698
"c:\Users\OlabayoBalogun\Documents\GitHub\AfroTada new website code\css\termsOfUse.css", "CSS", 0, 0, 0, 0, 363, 26, 74, 463
"c:\Users\OlabayoBalogun\Documents\GitHub\AfroTada new website code\css\togo.css", "CSS", 0, 0, 0, 0, 551, 26, 121, 698
"c:\Users\OlabayoBalogun\Documents\GitHub\AfroTada new website code\css\tunisia.css", "CSS", 0, 0, 0, 0, 551, 26, 121, 698
"c:\Users\OlabayoBalogun\Documents\GitHub\AfroTada new website code\css\uganda.css", "CSS", 0, 0, 0, 0, 551, 26, 121, 698
"c:\Users\OlabayoBalogun\Documents\GitHub\AfroTada new website code\css\volunteer.css", "CSS", 0, 0, 0, 0, 446, 26, 84, 556
"c:\Users\OlabayoBalogun\Documents\GitHub\AfroTada new website code\css\zambia.css", "CSS", 0, 0, 0, 0, 551, 26, 121, 698
"c:\Users\OlabayoBalogun\Documents\GitHub\AfroTada new website code\css\zimbabwe.css", "CSS", 0, 0, 0, 0, 551, 26, 121, 698
"c:\Users\OlabayoBalogun\Documents\GitHub\AfroTada new website code\dist\main.dev.js", "JavaScript", 0, 0, 0, 1, 0, 0, 0, 1
"c:\Users\OlabayoBalogun\Documents\GitHub\AfroTada new website code\djibouti.html", "HTML", 157, 0, 0, 0, 0, 8, 3, 168
"c:\Users\OlabayoBalogun\Documents\GitHub\AfroTada new website code\djiboutiBooks.html", "HTML", 75, 0, 0, 0, 0, 8, 2, 85
"c:\Users\OlabayoBalogun\Documents\GitHub\AfroTada new website code\djiboutiCulture.html", "HTML", 75, 0, 0, 0, 0, 8, 2, 85
"c:\Users\OlabayoBalogun\Documents\GitHub\AfroTada new website code\djiboutiDocumentaries.html", "HTML", 75, 0, 0, 0, 0, 8, 2, 85
"c:\Users\OlabayoBalogun\Documents\GitHub\AfroTada new website code\djiboutiFood.html", "HTML", 75, 0, 0, 0, 0, 8, 2, 85
"c:\Users\OlabayoBalogun\Documents\GitHub\AfroTada new website code\djiboutiHistoricalSites.html", "HTML", 75, 0, 0, 0, 0, 8, 2, 85
"c:\Users\OlabayoBalogun\Documents\GitHub\AfroTada new website code\djiboutiNaturalResources.html", "HTML", 75, 0, 0, 0, 0, 8, 2, 85
"c:\Users\OlabayoBalogun\Documents\GitHub\AfroTada new website code\djiboutiPodcasts.html", "HTML", 75, 0, 0, 0, 0, 8, 2, 85
"c:\Users\OlabayoBalogun\Documents\GitHub\AfroTada new website code\djiboutiPoets.html", "HTML", 75, 0, 0, 0, 0, 8, 2, 85
"c:\Users\OlabayoBalogun\Documents\GitHub\AfroTada new website code\djiboutiProverbs.html", "HTML", 75, 0, 0, 0, 0, 8, 2, 85
"c:\Users\OlabayoBalogun\Documents\GitHub\AfroTada new website code\djiboutiQuotes.html", "HTML", 75, 0, 0, 0, 0, 8, 2, 85
"c:\Users\OlabayoBalogun\Documents\GitHub\AfroTada new website code\djiboutiUniversities.html", "HTML", 75, 0, 0, 0, 0, 8, 2, 85
"c:\Users\OlabayoBalogun\Documents\GitHub\AfroTada new website code\djiboutiWriters.html", "HTML", 75, 0, 0, 0, 0, 8, 2, 85
"c:\Users\OlabayoBalogun\Documents\GitHub\AfroTada new website code\drCongo.html", "HTML", 157, 0, 0, 0, 0, 8, 3, 168
"c:\Users\OlabayoBalogun\Documents\GitHub\AfroTada new website code\drCongoBooks.html", "HTML", 75, 0, 0, 0, 0, 8, 2, 85
"c:\Users\OlabayoBalogun\Documents\GitHub\AfroTada new website code\drCongoCulture.html", "HTML", 75, 0, 0, 0, 0, 8, 2, 85
"c:\Users\OlabayoBalogun\Documents\GitHub\AfroTada new website code\drCongoDocumentaries.html", "HTML", 75, 0, 0, 0, 0, 8, 2, 85
"c:\Users\OlabayoBalogun\Documents\GitHub\AfroTada new website code\drCongoFood.html", "HTML", 75, 0, 0, 0, 0, 8, 2, 85
"c:\Users\OlabayoBalogun\Documents\GitHub\AfroTada new website code\drCongoHistoricalSites.html", "HTML", 75, 0, 0, 0, 0, 8, 2, 85
"c:\Users\OlabayoBalogun\Documents\GitHub\AfroTada new website code\drCongoNaturalResources.html", "HTML", 75, 0, 0, 0, 0, 8, 2, 85
"c:\Users\OlabayoBalogun\Documents\GitHub\AfroTada new website code\drCongoPodcasts.html", "HTML", 75, 0, 0, 0, 0, 8, 2, 85
"c:\Users\OlabayoBalogun\Documents\GitHub\AfroTada new website code\drCongoPoets.html", "HTML", 75, 0, 0, 0, 0, 8, 2, 85
"c:\Users\OlabayoBalogun\Documents\GitHub\AfroTada new website code\drCongoProverbs.html", "HTML", 75, 0, 0, 0, 0, 8, 2, 85
"c:\Users\OlabayoBalogun\Documents\GitHub\AfroTada new website code\drCongoQuotes.html", "HTML", 75, 0, 0, 0, 0, 8, 2, 85
"c:\Users\OlabayoBalogun\Documents\GitHub\AfroTada new website code\drCongoUniversities.html", "HTML", 75, 0, 0, 0, 0, 8, 2, 85
"c:\Users\OlabayoBalogun\Documents\GitHub\AfroTada new website code\drCongoWriters.html", "HTML", 75, 0, 0, 0, 0, 8, 2, 85
"c:\Users\OlabayoBalogun\Documents\GitHub\AfroTada new website code\egypt.html", "HTML", 157, 0, 0, 0, 0, 8, 3, 168
"c:\Users\OlabayoBalogun\Documents\GitHub\AfroTada new website code\egyptBooks.html", "HTML", 75, 0, 0, 0, 0, 8, 2, 85
"c:\Users\OlabayoBalogun\Documents\GitHub\AfroTada new website code\egyptCulture.html", "HTML", 75, 0, 0, 0, 0, 8, 2, 85
"c:\Users\OlabayoBalogun\Documents\GitHub\AfroTada new website code\egyptDocumentaries.html", "HTML", 75, 0, 0, 0, 0, 8, 2, 85
"c:\Users\OlabayoBalogun\Documents\GitHub\AfroTada new website code\egyptFood.html", "HTML", 76, 0, 0, 0, 0, 8, 2, 86
"c:\Users\OlabayoBalogun\Documents\GitHub\AfroTada new website code\egyptHistoricalSites.html", "HTML", 75, 0, 0, 0, 0, 8, 2, 85
"c:\Users\OlabayoBalogun\Documents\GitHub\AfroTada new website code\egyptNaturalResources.html", "HTML", 75, 0, 0, 0, 0, 8, 2, 85
"c:\Users\OlabayoBalogun\Documents\GitHub\AfroTada new website code\egyptPodcasts.html", "HTML", 75, 0, 0, 0, 0, 8, 2, 85
"c:\Users\OlabayoBalogun\Documents\GitHub\AfroTada new website code\egyptPoets.html", "HTML", 75, 0, 0, 0, 0, 8, 2, 85
"c:\Users\OlabayoBalogun\Documents\GitHub\AfroTada new website code\egyptProverbs.html", "HTML", 75, 0, 0, 0, 0, 8, 2, 85
"c:\Users\OlabayoBalogun\Documents\GitHub\AfroTada new website code\egyptQuotes.html", "HTML", 75, 0, 0, 0, 0, 8, 2, 85
"c:\Users\OlabayoBalogun\Documents\GitHub\AfroTada new website code\egyptUniversities.html", "HTML", 75, 0, 0, 0, 0, 8, 2, 85
"c:\Users\OlabayoBalogun\Documents\GitHub\AfroTada new website code\egyptWriters.html", "HTML", 75, 0, 0, 0, 0, 8, 2, 85
"c:\Users\OlabayoBalogun\Documents\GitHub\AfroTada new website code\equatorialGuinea.html", "HTML", 157, 0, 0, 0, 0, 8, 3, 168
"c:\Users\OlabayoBalogun\Documents\GitHub\AfroTada new website code\equatorialGuineaBooks.html", "HTML", 75, 0, 0, 0, 0, 8, 2, 85
"c:\Users\OlabayoBalogun\Documents\GitHub\AfroTada new website code\equatorialGuineaCulture.html", "HTML", 75, 0, 0, 0, 0, 8, 2, 85
"c:\Users\OlabayoBalogun\Documents\GitHub\AfroTada new website code\equatorialGuineaDocumentaries.html", "HTML", 75, 0, 0, 0, 0, 8, 2, 85
"c:\Users\OlabayoBalogun\Documents\GitHub\AfroTada new website code\equatorialGuineaFood.html", "HTML", 75, 0, 0, 0, 0, 8, 2, 85
"c:\Users\OlabayoBalogun\Documents\GitHub\AfroTada new website code\equatorialGuineaHistoricalSites.html", "HTML", 75, 0, 0, 0, 0, 8, 2, 85
"c:\Users\OlabayoBalogun\Documents\GitHub\AfroTada new website code\equatorialGuineaNaturalResources.html", "HTML", 75, 0, 0, 0, 0, 8, 2, 85
"c:\Users\OlabayoBalogun\Documents\GitHub\AfroTada new website code\equatorialGuineaPodcasts.html", "HTML", 75, 0, 0, 0, 0, 8, 2, 85
"c:\Users\OlabayoBalogun\Documents\GitHub\AfroTada new website code\equatorialGuineaPoets.html", "HTML", 75, 0, 0, 0, 0, 8, 2, 85
"c:\Users\OlabayoBalogun\Documents\GitHub\AfroTada new website code\equatorialGuineaProverbs.html", "HTML", 75, 0, 0, 0, 0, 8, 2, 85
"c:\Users\OlabayoBalogun\Documents\GitHub\AfroTada new website code\equatorialGuineaQuotes.html", "HTML", 75, 0, 0, 0, 0, 8, 2, 85
"c:\Users\OlabayoBalogun\Documents\GitHub\AfroTada new website code\equatorialGuineaUniversities.html", "HTML", 75, 0, 0, 0, 0, 8, 2, 85
"c:\Users\OlabayoBalogun\Documents\GitHub\AfroTada new website code\equatorialGuineaWriters.html", "HTML", 75, 0, 0, 0, 0, 8, 2, 85
"c:\Users\OlabayoBalogun\Documents\GitHub\AfroTada new website code\eritrea.html", "HTML", 157, 0, 0, 0, 0, 8, 3, 168
"c:\Users\OlabayoBalogun\Documents\GitHub\AfroTada new website code\eritreaBooks.html", "HTML", 150, 0, 0, 0, 0, 16, 4, 170
"c:\Users\OlabayoBalogun\Documents\GitHub\AfroTada new website code\eritreaCulture.html", "HTML", 75, 0, 0, 0, 0, 8, 2, 85
"c:\Users\OlabayoBalogun\Documents\GitHub\AfroTada new website code\eritreaDocumentaries.html", "HTML", 75, 0, 0, 0, 0, 8, 2, 85
"c:\Users\OlabayoBalogun\Documents\GitHub\AfroTada new website code\eritreaFood.html", "HTML", 75, 0, 0, 0, 0, 8, 2, 85
"c:\Users\OlabayoBalogun\Documents\GitHub\AfroTada new website code\eritreaHistoricalSites.html", "HTML", 75, 0, 0, 0, 0, 8, 3, 86
"c:\Users\OlabayoBalogun\Documents\GitHub\AfroTada new website code\eritreaNaturalResources.html", "HTML", 75, 0, 0, 0, 0, 8, 2, 85
"c:\Users\OlabayoBalogun\Documents\GitHub\AfroTada new website code\eritreaPodcasts.html", "HTML", 75, 0, 0, 0, 0, 8, 2, 85
"c:\Users\OlabayoBalogun\Documents\GitHub\AfroTada new website code\eritreaPoets.html", "HTML", 75, 0, 0, 0, 0, 8, 2, 85
"c:\Users\OlabayoBalogun\Documents\GitHub\AfroTada new website code\eritreaProverbs.html", "HTML", 75, 0, 0, 0, 0, 8, 2, 85
"c:\Users\OlabayoBalogun\Documents\GitHub\AfroTada new website code\eritreaQuotes.html", "HTML", 75, 0, 0, 0, 0, 8, 2, 85
"c:\Users\OlabayoBalogun\Documents\GitHub\AfroTada new website code\eritreaUniversities.html", "HTML", 75, 0, 0, 0, 0, 8, 2, 85
"c:\Users\OlabayoBalogun\Documents\GitHub\AfroTada new website code\eritreaWriters.html", "HTML", 75, 0, 0, 0, 0, 8, 2, 85
"c:\Users\OlabayoBalogun\Documents\GitHub\AfroTada new website code\eswatini.html", "HTML", 157, 0, 0, 0, 0, 8, 3, 168
"c:\Users\OlabayoBalogun\Documents\GitHub\AfroTada new website code\eswatiniBooks.html", "HTML", 75, 0, 0, 0, 0, 8, 2, 85
"c:\Users\OlabayoBalogun\Documents\GitHub\AfroTada new website code\eswatiniCulture.html", "HTML", 75, 0, 0, 0, 0, 8, 2, 85
"c:\Users\OlabayoBalogun\Documents\GitHub\AfroTada new website code\eswatiniDocumentaries.html", "HTML", 75, 0, 0, 0, 0, 8, 2, 85
"c:\Users\OlabayoBalogun\Documents\GitHub\AfroTada new website code\eswatiniFood.html", "HTML", 75, 0, 0, 0, 0, 8, 2, 85
"c:\Users\OlabayoBalogun\Documents\GitHub\AfroTada new website code\eswatiniHistoricalSites.html", "HTML", 75, 0, 0, 0, 0, 8, 2, 85
"c:\Users\OlabayoBalogun\Documents\GitHub\AfroTada new website code\eswatiniNaturalResources.html", "HTML", 75, 0, 0, 0, 0, 8, 2, 85
"c:\Users\OlabayoBalogun\Documents\GitHub\AfroTada new website code\eswatiniPodcasts.html", "HTML", 75, 0, 0, 0, 0, 8, 2, 85
"c:\Users\OlabayoBalogun\Documents\GitHub\AfroTada new website code\eswatiniPoets.html", "HTML", 75, 0, 0, 0, 0, 8, 2, 85
"c:\Users\OlabayoBalogun\Documents\GitHub\AfroTada new website code\eswatiniProverbs.html", "HTML", 75, 0, 0, 0, 0, 8, 2, 85
"c:\Users\OlabayoBalogun\Documents\GitHub\AfroTada new website code\eswatiniQuotes.html", "HTML", 75, 0, 0, 0, 0, 8, 2, 85
"c:\Users\OlabayoBalogun\Documents\GitHub\AfroTada new website code\eswatiniUniversities.html", "HTML", 75, 0, 0, 0, 0, 8, 2, 85
"c:\Users\OlabayoBalogun\Documents\GitHub\AfroTada new website code\eswatiniWriters.html", "HTML", 75, 0, 0, 0, 0, 8, 2, 85
"c:\Users\OlabayoBalogun\Documents\GitHub\AfroTada new website code\ethiopia.html", "HTML", 157, 0, 0, 0, 0, 8, 3, 168
"c:\Users\OlabayoBalogun\Documents\GitHub\AfroTada new website code\ethiopiaBooks.html", "HTML", 75, 0, 0, 0, 0, 8, 2, 85
"c:\Users\OlabayoBalogun\Documents\GitHub\AfroTada new website code\ethiopiaCulture.html", "HTML", 75, 0, 0, 0, 0, 8, 2, 85
"c:\Users\OlabayoBalogun\Documents\GitHub\AfroTada new website code\ethiopiaDocumentaries.html", "HTML", 75, 0, 0, 0, 0, 8, 2, 85
"c:\Users\OlabayoBalogun\Documents\GitHub\AfroTada new website code\ethiopiaFood.html", "HTML", 75, 0, 0, 0, 0, 8, 2, 85
"c:\Users\OlabayoBalogun\Documents\GitHub\AfroTada new website code\ethiopiaHistoricalSites.html", "HTML", 75, 0, 0, 0, 0, 8, 2, 85
"c:\Users\OlabayoBalogun\Documents\GitHub\AfroTada new website code\ethiopiaNaturalResources.html", "HTML", 75, 0, 0, 0, 0, 8, 2, 85
"c:\Users\OlabayoBalogun\Documents\GitHub\AfroTada new website code\ethiopiaPodcasts.html", "HTML", 75, 0, 0, 0, 0, 8, 2, 85
"c:\Users\OlabayoBalogun\Documents\GitHub\AfroTada new website code\ethiopiaPoets.html", "HTML", 75, 0, 0, 0, 0, 8, 2, 85
"c:\Users\OlabayoBalogun\Documents\GitHub\AfroTada new website code\ethiopiaProverbs.html", "HTML", 75, 0, 0, 0, 0, 8, 2, 85
"c:\Users\OlabayoBalogun\Documents\GitHub\AfroTada new website code\ethiopiaQuotes.html", "HTML", 75, 0, 0, 0, 0, 8, 2, 85
"c:\Users\OlabayoBalogun\Documents\GitHub\AfroTada new website code\ethiopiaUniversities.html", "HTML", 75, 0, 0, 0, 0, 8, 2, 85
"c:\Users\OlabayoBalogun\Documents\GitHub\AfroTada new website code\ethiopiaWriters.html", "HTML", 75, 0, 0, 0, 0, 8, 2, 85
"c:\Users\OlabayoBalogun\Documents\GitHub\AfroTada new website code\gabon.html", "HTML", 157, 0, 0, 0, 0, 8, 3, 168
"c:\Users\OlabayoBalogun\Documents\GitHub\AfroTada new website code\gabonBooks.html", "HTML", 75, 0, 0, 0, 0, 8, 2, 85
"c:\Users\OlabayoBalogun\Documents\GitHub\AfroTada new website code\gabonCulture.html", "HTML", 75, 0, 0, 0, 0, 8, 2, 85
"c:\Users\OlabayoBalogun\Documents\GitHub\AfroTada new website code\gabonDocumentaries.html", "HTML", 75, 0, 0, 0, 0, 8, 2, 85
"c:\Users\OlabayoBalogun\Documents\GitHub\AfroTada new website code\gabonFood.html", "HTML", 75, 0, 0, 0, 0, 8, 2, 85
"c:\Users\OlabayoBalogun\Documents\GitHub\AfroTada new website code\gabonHistoricalSites.html", "HTML", 75, 0, 0, 0, 0, 8, 2, 85
"c:\Users\OlabayoBalogun\Documents\GitHub\AfroTada new website code\gabonNaturalResources.html", "HTML", 75, 0, 0, 0, 0, 8, 2, 85
"c:\Users\OlabayoBalogun\Documents\GitHub\AfroTada new website code\gabonPodcasts.html", "HTML", 75, 0, 0, 0, 0, 8, 2, 85
"c:\Users\OlabayoBalogun\Documents\GitHub\AfroTada new website code\gabonPoets.html", "HTML", 75, 0, 0, 0, 0, 8, 2, 85
"c:\Users\OlabayoBalogun\Documents\GitHub\AfroTada new website code\gabonProverbs.html", "HTML", 75, 0, 0, 0, 0, 8, 2, 85
"c:\Users\OlabayoBalogun\Documents\GitHub\AfroTada new website code\gabonQuotes.html", "HTML", 75, 0, 0, 0, 0, 8, 2, 85
"c:\Users\OlabayoBalogun\Documents\GitHub\AfroTada new website code\gabonUniversities.html", "HTML", 75, 0, 0, 0, 0, 8, 2, 85
"c:\Users\OlabayoBalogun\Documents\GitHub\AfroTada new website code\gabonWriters.html", "HTML", 75, 0, 0, 0, 0, 8, 2, 85
"c:\Users\OlabayoBalogun\Documents\GitHub\AfroTada new website code\gambia.html", "HTML", 157, 0, 0, 0, 0, 8, 3, 168
"c:\Users\OlabayoBalogun\Documents\GitHub\AfroTada new website code\gambiaBooks.html", "HTML", 75, 0, 0, 0, 0, 8, 2, 85
"c:\Users\OlabayoBalogun\Documents\GitHub\AfroTada new website code\gambiaCulture.html", "HTML", 75, 0, 0, 0, 0, 8, 2, 85
"c:\Users\OlabayoBalogun\Documents\GitHub\AfroTada new website code\gambiaDocumentaries.html", "HTML", 75, 0, 0, 0, 0, 8, 2, 85
"c:\Users\OlabayoBalogun\Documents\GitHub\AfroTada new website code\gambiaFood.html", "HTML", 75, 0, 0, 0, 0, 8, 2, 85
"c:\Users\OlabayoBalogun\Documents\GitHub\AfroTada new website code\gambiaHistoricalSites.html", "HTML", 75, 0, 0, 0, 0, 8, 2, 85
"c:\Users\OlabayoBalogun\Documents\GitHub\AfroTada new website code\gambiaNaturalResources.html", "HTML", 75, 0, 0, 0, 0, 8, 2, 85
"c:\Users\OlabayoBalogun\Documents\GitHub\AfroTada new website code\gambiaPodcasts.html", "HTML", 75, 0, 0, 0, 0, 8, 2, 85
"c:\Users\OlabayoBalogun\Documents\GitHub\AfroTada new website code\gambiaPoets.html", "HTML", 75, 0, 0, 0, 0, 8, 2, 85
"c:\Users\OlabayoBalogun\Documents\GitHub\AfroTada new website code\gambiaProverbs.html", "HTML", 75, 0, 0, 0, 0, 8, 2, 85
"c:\Users\OlabayoBalogun\Documents\GitHub\AfroTada new website code\gambiaQuotes.html", "HTML", 75, 0, 0, 0, 0, 8, 2, 85
"c:\Users\OlabayoBalogun\Documents\GitHub\AfroTada new website code\gambiaUniversities.html", "HTML", 75, 0, 0, 0, 0, 8, 2, 85
"c:\Users\OlabayoBalogun\Documents\GitHub\AfroTada new website code\gambiaWriters.html", "HTML", 75, 0, 0, 0, 0, 8, 2, 85
"c:\Users\OlabayoBalogun\Documents\GitHub\AfroTada new website code\ghana.html", "HTML", 157, 0, 0, 0, 0, 8, 3, 168
"c:\Users\OlabayoBalogun\Documents\GitHub\AfroTada new website code\ghanaBooks.html", "HTML", 75, 0, 0, 0, 0, 8, 2, 85
"c:\Users\OlabayoBalogun\Documents\GitHub\AfroTada new website code\ghanaCulture.html", "HTML", 75, 0, 0, 0, 0, 8, 2, 85
"c:\Users\OlabayoBalogun\Documents\GitHub\AfroTada new website code\ghanaDocumentaries.html", "HTML", 75, 0, 0, 0, 0, 8, 2, 85
"c:\Users\OlabayoBalogun\Documents\GitHub\AfroTada new website code\ghanaFood.html", "HTML", 75, 0, 0, 0, 0, 8, 2, 85
"c:\Users\OlabayoBalogun\Documents\GitHub\AfroTada new website code\ghanaHistoricalSites.html", "HTML", 75, 0, 0, 0, 0, 8, 2, 85
"c:\Users\OlabayoBalogun\Documents\GitHub\AfroTada new website code\ghanaNaturalResources.html", "HTML", 75, 0, 0, 0, 0, 8, 2, 85
"c:\Users\OlabayoBalogun\Documents\GitHub\AfroTada new website code\ghanaPodcasts.html", "HTML", 75, 0, 0, 0, 0, 8, 2, 85
"c:\Users\OlabayoBalogun\Documents\GitHub\AfroTada new website code\ghanaPoets.html", "HTML", 75, 0, 0, 0, 0, 8, 2, 85
"c:\Users\OlabayoBalogun\Documents\GitHub\AfroTada new website code\ghanaProverbs.html", "HTML", 75, 0, 0, 0, 0, 8, 2, 85
"c:\Users\OlabayoBalogun\Documents\GitHub\AfroTada new website code\ghanaQuotes.html", "HTML", 75, 0, 0, 0, 0, 8, 2, 85
"c:\Users\OlabayoBalogun\Documents\GitHub\AfroTada new website code\ghanaUniversities.html", "HTML", 75, 0, 0, 0, 0, 8, 2, 85
"c:\Users\OlabayoBalogun\Documents\GitHub\AfroTada new website code\ghanaWriters.html", "HTML", 75, 0, 0, 0, 0, 8, 2, 85
"c:\Users\OlabayoBalogun\Documents\GitHub\AfroTada new website code\guinea.html", "HTML", 158, 0, 0, 0, 0, 8, 3, 169
"c:\Users\OlabayoBalogun\Documents\GitHub\AfroTada new website code\guineaBissau.html", "HTML", 157, 0, 0, 0, 0, 8, 3, 168
"c:\Users\OlabayoBalogun\Documents\GitHub\AfroTada new website code\guineaBissauBooks.html", "HTML", 75, 0, 0, 0, 0, 8, 2, 85
"c:\Users\OlabayoBalogun\Documents\GitHub\AfroTada new website code\guineaBissauCulture.html", "HTML", 75, 0, 0, 0, 0, 8, 2, 85
"c:\Users\OlabayoBalogun\Documents\GitHub\AfroTada new website code\guineaBissauDocumentaries.html", "HTML", 75, 0, 0, 0, 0, 8, 2, 85
"c:\Users\OlabayoBalogun\Documents\GitHub\AfroTada new website code\guineaBissauFood.html", "HTML", 75, 0, 0, 0, 0, 8, 2, 85
"c:\Users\OlabayoBalogun\Documents\GitHub\AfroTada new website code\guineaBissauHistoricalSites.html", "HTML", 75, 0, 0, 0, 0, 8, 2, 85
"c:\Users\OlabayoBalogun\Documents\GitHub\AfroTada new website code\guineaBissauNaturalResources.html", "HTML", 75, 0, 0, 0, 0, 8, 2, 85
"c:\Users\OlabayoBalogun\Documents\GitHub\AfroTada new website code\guineaBissauPodcasts.html", "HTML", 75, 0, 0, 0, 0, 8, 2, 85
"c:\Users\OlabayoBalogun\Documents\GitHub\AfroTada new website code\guineaBissauPoets.html", "HTML", 75, 0, 0, 0, 0, 8, 2, 85
"c:\Users\OlabayoBalogun\Documents\GitHub\AfroTada new website code\guineaBissauProverbs.html", "HTML", 75, 0, 0, 0, 0, 8, 2, 85
"c:\Users\OlabayoBalogun\Documents\GitHub\AfroTada new website code\guineaBissauQuotes.html", "HTML", 75, 0, 0, 0, 0, 8, 2, 85
"c:\Users\OlabayoBalogun\Documents\GitHub\AfroTada new website code\guineaBissauUniversities.html", "HTML", 75, 0, 0, 0, 0, 8, 2, 85
"c:\Users\OlabayoBalogun\Documents\GitHub\AfroTada new website code\guineaBissauWriters.html", "HTML", 75, 0, 0, 0, 0, 8, 2, 85
"c:\Users\OlabayoBalogun\Documents\GitHub\AfroTada new website code\guineaBooks.html", "HTML", 76, 0, 0, 0, 0, 8, 2, 86
"c:\Users\OlabayoBalogun\Documents\GitHub\AfroTada new website code\guineaCulture.html", "HTML", 75, 0, 0, 0, 0, 8, 2, 85
"c:\Users\OlabayoBalogun\Documents\GitHub\AfroTada new website code\guineaDocumentaries.html", "HTML", 75, 0, 0, 0, 0, 8, 2, 85
"c:\Users\OlabayoBalogun\Documents\GitHub\AfroTada new website code\guineaFood.html", "HTML", 75, 0, 0, 0, 0, 8, 2, 85
"c:\Users\OlabayoBalogun\Documents\GitHub\AfroTada new website code\guineaHistoricalSites.html", "HTML", 75, 0, 0, 0, 0, 8, 2, 85
"c:\Users\OlabayoBalogun\Documents\GitHub\AfroTada new website code\guineaNaturalResources.html", "HTML", 75, 0, 0, 0, 0, 8, 2, 85
"c:\Users\OlabayoBalogun\Documents\GitHub\AfroTada new website code\guineaPodcasts.html", "HTML", 75, 0, 0, 0, 0, 8, 2, 85
"c:\Users\OlabayoBalogun\Documents\GitHub\AfroTada new website code\guineaPoets.html", "HTML", 75, 0, 0, 0, 0, 8, 2, 85
"c:\Users\OlabayoBalogun\Documents\GitHub\AfroTada new website code\guineaProverbs.html", "HTML", 75, 0, 0, 0, 0, 8, 2, 85
"c:\Users\OlabayoBalogun\Documents\GitHub\AfroTada new website code\guineaQuotes.html", "HTML", 75, 0, 0, 0, 0, 8, 2, 85
"c:\Users\OlabayoBalogun\Documents\GitHub\AfroTada new website code\guineaUniversities.html", "HTML", 75, 0, 0, 0, 0, 8, 2, 85
"c:\Users\OlabayoBalogun\Documents\GitHub\AfroTada new website code\guineaWriters.html", "HTML", 75, 0, 0, 0, 0, 8, 2, 85
"c:\Users\OlabayoBalogun\Documents\GitHub\AfroTada new website code\img\1 hover.svg", "XML", 0, 0, 4, 0, 0, 0, 1, 5
"c:\Users\OlabayoBalogun\Documents\GitHub\AfroTada new website code\img\1.svg", "XML", 0, 0, 4, 0, 0, 0, 1, 5
"c:\Users\OlabayoBalogun\Documents\GitHub\AfroTada new website code\img\2 hover.svg", "XML", 0, 0, 4, 0, 0, 0, 1, 5
"c:\Users\OlabayoBalogun\Documents\GitHub\AfroTada new website code\img\2.svg", "XML", 0, 0, 4, 0, 0, 0, 1, 5
"c:\Users\OlabayoBalogun\Documents\GitHub\AfroTada new website code\img\3 hover.svg", "XML", 0, 0, 4, 0, 0, 0, 1, 5
"c:\Users\OlabayoBalogun\Documents\GitHub\AfroTada new website code\img\3.svg", "XML", 0, 0, 4, 0, 0, 0, 1, 5
"c:\Users\OlabayoBalogun\Documents\GitHub\AfroTada new website code\img\4 hover.svg", "XML", 0, 0, 4, 0, 0, 0, 1, 5
"c:\Users\OlabayoBalogun\Documents\GitHub\AfroTada new website code\img\4.svg", "XML", 0, 0, 4, 0, 0, 0, 1, 5
"c:\Users\OlabayoBalogun\Documents\GitHub\AfroTada new website code\img\5 hover.svg", "XML", 0, 0, 4, 0, 0, 0, 1, 5
"c:\Users\OlabayoBalogun\Documents\GitHub\AfroTada new website code\img\5.svg", "XML", 0, 0, 4, 0, 0, 0, 1, 5
"c:\Users\OlabayoBalogun\Documents\GitHub\AfroTada new website code\img\6 hover.svg", "XML", 0, 0, 4, 0, 0, 0, 1, 5
"c:\Users\OlabayoBalogun\Documents\GitHub\AfroTada new website code\img\6.svg", "XML", 0, 0, 4, 0, 0, 0, 1, 5
"c:\Users\OlabayoBalogun\Documents\GitHub\AfroTada new website code\img\African culture.svg", "XML", 0, 0, 44, 0, 0, 0, 1, 45
"c:\Users\OlabayoBalogun\Documents\GitHub\AfroTada new website code\img\African documentaries.svg", "XML", 0, 0, 39, 0, 0, 0, 1, 40
"c:\Users\OlabayoBalogun\Documents\GitHub\AfroTada new website code\img\African food.svg", "XML", 0, 0, 39, 0, 0, 0, 1, 40
"c:\Users\OlabayoBalogun\Documents\GitHub\AfroTada new website code\img\African historical sites.svg", "XML", 0, 0, 29, 0, 0, 0, 1, 30
"c:\Users\OlabayoBalogun\Documents\GitHub\AfroTada new website code\img\African natural resources.svg", "XML", 0, 0, 39, 0, 0, 0, 1, 40
"c:\Users\OlabayoBalogun\Documents\GitHub\AfroTada new website code\img\African podcasts (1).svg", "XML", 0, 0, 29, 0, 0, 0, 1, 30
"c:\Users\OlabayoBalogun\Documents\GitHub\AfroTada new website code\img\African podcasts.svg", "XML", 0, 0, 29, 0, 0, 0, 1, 30
"c:\Users\OlabayoBalogun\Documents\GitHub\AfroTada new website code\img\African poets.svg", "XML", 0, 0, 22, 0, 0, 0, 1, 23
"c:\Users\OlabayoBalogun\Documents\GitHub\AfroTada new website code\img\African proverbs.svg", "XML", 0, 0, 10, 0, 0, 0, 1, 11
"c:\Users\OlabayoBalogun\Documents\GitHub\AfroTada new website code\img\African quotes.svg", "XML", 0, 0, 26, 0, 0, 0, 1, 27
"c:\Users\OlabayoBalogun\Documents\GitHub\AfroTada new website code\img\African writers.svg", "XML", 0, 0, 18, 0, 0, 0, 1, 19
"c:\Users\OlabayoBalogun\Documents\GitHub\AfroTada new website code\img\AfroTada with shadow small.svg", "XML", 0, 0, 6, 0, 0, 0, 1, 7
"c:\Users\OlabayoBalogun\Documents\GitHub\AfroTada new website code\img\AfroTada with shadow.svg", "XML", 0, 0, 6, 0, 0, 0, 1, 7
"c:\Users\OlabayoBalogun\Documents\GitHub\AfroTada new website code\img\AfroTada with text and shadow.svg", "XML", 0, 0, 16, 0, 0, 0, 1, 17
"c:\Users\OlabayoBalogun\Documents\GitHub\AfroTada new website code\img\Algeria.svg", "XML", 0, 0, 8, 0, 0, 0, 1, 9
"c:\Users\OlabayoBalogun\Documents\GitHub\AfroTada new website code\img\Angola flag.svg", "XML", 0, 0, 8, 0, 0, 0, 1, 9
"c:\Users\OlabayoBalogun\Documents\GitHub\AfroTada new website code\img\Benin flag.svg", "XML", 0, 0, 8, 0, 0, 0, 1, 9
"c:\Users\OlabayoBalogun\Documents\GitHub\AfroTada new website code\img\Books.svg", "XML", 0, 0, 16, 0, 0, 0, 1, 17
"c:\Users\OlabayoBalogun\Documents\GitHub\AfroTada new website code\img\Botswana flag.svg", "XML", 0, 0, 8, 0, 0, 0, 1, 9
"c:\Users\OlabayoBalogun\Documents\GitHub\AfroTada new website code\img\BurkinaFaso flag.svg", "XML", 0, 0, 8, 0, 0, 0, 1, 9
"c:\Users\OlabayoBalogun\Documents\GitHub\AfroTada new website code\img\Burundi flag.svg", "XML", 0, 0, 8, 0, 0, 0, 1, 9
"c:\Users\OlabayoBalogun\Documents\GitHub\AfroTada new website code\img\Cameroon flag.svg", "XML", 0, 0, 8, 0, 0, 0, 1, 9
"c:\Users\OlabayoBalogun\Documents\GitHub\AfroTada new website code\img\Cape verde flag.svg", "XML", 0, 0, 8, 0, 0, 0, 1, 9
"c:\Users\OlabayoBalogun\Documents\GitHub\AfroTada new website code\img\Chad flag.svg", "XML", 0, 0, 8, 0, 0, 0, 1, 9
"c:\Users\OlabayoBalogun\Documents\GitHub\AfroTada new website code\img\Coming soon normal.svg", "XML", 0, 0, 81, 0, 0, 0, 7, 88
"c:\Users\OlabayoBalogun\Documents\GitHub\AfroTada new website code\img\Coming soon svg.svg", "XML", 0, 0, 58, 0, 0, 0, 1, 59
"c:\Users\OlabayoBalogun\Documents\GitHub\AfroTada new website code\img\Comoros flag.svg", "XML", 0, 0, 8, 0, 0, 0, 1, 9
"c:\Users\OlabayoBalogun\Documents\GitHub\AfroTada new website code\img\Côté D'Ivoire flag.svg", "XML", 0, 0, 8, 0, 0, 0, 1, 9
"c:\Users\OlabayoBalogun\Documents\GitHub\AfroTada new website code\img\Democratic Republic of the Congo flag.svg", "XML", 0, 0, 8, 0, 0, 0, 1, 9
"c:\Users\OlabayoBalogun\Documents\GitHub\AfroTada new website code\img\Djibouti flag.svg", "XML", 0, 0, 8, 0, 0, 0, 1, 9
"c:\Users\OlabayoBalogun\Documents\GitHub\AfroTada new website code\img\Egypt flag.svg", "XML", 0, 0, 8, 0, 0, 0, 1, 9
"c:\Users\OlabayoBalogun\Documents\GitHub\AfroTada new website code\img\Ellipse 34.svg", "XML", 0, 0, 3, 0, 0, 0, 1, 4
"c:\Users\OlabayoBalogun\Documents\GitHub\AfroTada new website code\img\Equatorial Guinea.svg", "XML", 0, 0, 8, 0, 0, 0, 1, 9
"c:\Users\OlabayoBalogun\Documents\GitHub\AfroTada new website code\img\Eritrea.svg", "XML", 0, 0, 8, 0, 0, 0, 1, 9
"c:\Users\OlabayoBalogun\Documents\GitHub\AfroTada new website code\img\Ethiopia.svg", "XML", 0, 0, 8, 0, 0, 0, 1, 9
"c:\Users\OlabayoBalogun\Documents\GitHub\AfroTada new website code\img\First page hover.svg", "XML", 0, 0, 7, 0, 0, 0, 1, 8
"c:\Users\OlabayoBalogun\Documents\GitHub\AfroTada new website code\img\First page.svg", "XML", 0, 0, 9, 0, 0, 0, 1, 10
"c:\Users\OlabayoBalogun\Documents\GitHub\AfroTada new website code\img\Gabon flag.svg", "XML", 0, 0, 8, 0, 0, 0, 1, 9
"c:\Users\OlabayoBalogun\Documents\GitHub\AfroTada new website code\img\Gambia flag.svg", "XML", 0, 0, 8, 0, 0, 0, 1, 9
"c:\Users\OlabayoBalogun\Documents\GitHub\AfroTada new website code\img\Ghana.svg", "XML", 0, 0, 8, 0, 0, 0, 1, 9
"c:\Users\OlabayoBalogun\Documents\GitHub\AfroTada new website code\img\Guinea flag.svg", "XML", 0, 0, 8, 0, 0, 0, 1, 9
"c:\Users\OlabayoBalogun\Documents\GitHub\AfroTada new website code\img\Guinea-bissau flag.svg", "XML", 0, 0, 8, 0, 0, 0, 1, 9
"c:\Users\OlabayoBalogun\Documents\GitHub\AfroTada new website code\img\Hamburger menu.svg", "XML", 0, 0, 7, 0, 0, 0, 1, 8
"c:\Users\OlabayoBalogun\Documents\GitHub\AfroTada new website code\img\Icon awesome-facebook.svg", "XML", 0, 0, 3, 0, 0, 0, 1, 4
"c:\Users\OlabayoBalogun\Documents\GitHub\AfroTada new website code\img\Icon awesome-twitter.svg", "XML", 0, 0, 3, 0, 0, 0, 1, 4
"c:\Users\OlabayoBalogun\Documents\GitHub\AfroTada new website code\img\Icon material-switch (1).svg", "XML", 0, 0, 3, 0, 0, 0, 1, 4
"c:\Users\OlabayoBalogun\Documents\GitHub\AfroTada new website code\img\Icon material-switch.svg", "XML", 0, 0, 3, 0, 0, 0, 1, 4
"c:\Users\OlabayoBalogun\Documents\GitHub\AfroTada new website code\img\Icon simple-instagram.svg", "XML", 0, 0, 3, 0, 0, 0, 1, 4
"c:\Users\OlabayoBalogun\Documents\GitHub\AfroTada new website code\img\Kenya flag.svg", "XML", 0, 0, 8, 0, 0, 0, 1, 9
"c:\Users\OlabayoBalogun\Documents\GitHub\AfroTada new website code\img\Last page hover.svg", "XML", 0, 0, 7, 0, 0, 0, 1, 8
"c:\Users\OlabayoBalogun\Documents\GitHub\AfroTada new website code\img\Last page.svg", "XML", 0, 0, 7, 0, 0, 0, 1, 8
"c:\Users\OlabayoBalogun\Documents\GitHub\AfroTada new website code\img\Lesotho.svg", "XML", 0, 0, 8, 0, 0, 0, 1, 9
"c:\Users\OlabayoBalogun\Documents\GitHub\AfroTada new website code\img\Liberia flag.svg", "XML", 0, 0, 8, 0, 0, 0, 1, 9
"c:\Users\OlabayoBalogun\Documents\GitHub\AfroTada new website code\img\Line 32.svg", "XML", 0, 0, 3, 0, 0, 0, 1, 4
"c:\Users\OlabayoBalogun\Documents\GitHub\AfroTada new website code\img\Line 34.svg", "XML", 0, 0, 3, 0, 0, 0, 1, 4
"c:\Users\OlabayoBalogun\Documents\GitHub\AfroTada new website code\img\Madagascar flag.svg", "XML", 0, 0, 8, 0, 0, 0, 1, 9
"c:\Users\OlabayoBalogun\Documents\GitHub\AfroTada new website code\img\Mali.svg", "XML", 0, 0, 8, 0, 0, 0, 1, 9
"c:\Users\OlabayoBalogun\Documents\GitHub\AfroTada new website code\img\Mauritania flag.svg", "XML", 0, 0, 8, 0, 0, 0, 1, 9
"c:\Users\OlabayoBalogun\Documents\GitHub\AfroTada new website code\img\Mauritius flag.svg", "XML", 0, 0, 8, 0, 0, 0, 1, 9
"c:\Users\OlabayoBalogun\Documents\GitHub\AfroTada new website code\img\Morocco flag.svg", "XML", 0, 0, 8, 0, 0, 0, 1, 9
"c:\Users\OlabayoBalogun\Documents\GitHub\AfroTada new website code\img\Mozambique.svg", "XML", 0, 0, 8, 0, 0, 0, 1, 9
"c:\Users\OlabayoBalogun\Documents\GitHub\AfroTada new website code\img\Namibia flag.svg", "XML", 0, 0, 8, 0, 0, 0, 1, 9
"c:\Users\OlabayoBalogun\Documents\GitHub\AfroTada new website code\img\Next page hover.svg", "XML", 0, 0, 4, 0, 0, 0, 1, 5
"c:\Users\OlabayoBalogun\Documents\GitHub\AfroTada new website code\img\Next page.svg", "XML", 0, 0, 4, 0, 0, 0, 1, 5
"c:\Users\OlabayoBalogun\Documents\GitHub\AfroTada new website code\img\Nigeria flag.svg", "XML", 0, 0, 8, 0, 0, 0, 1, 9
"c:\Users\OlabayoBalogun\Documents\GitHub\AfroTada new website code\img\Page-1.svg", "XML", 0, 0, 29, 0, 0, 0, 1, 30
"c:\Users\OlabayoBalogun\Documents\GitHub\AfroTada new website code\img\Previous page hover.svg", "XML", 0, 0, 4, 0, 0, 0, 1, 5
"c:\Users\OlabayoBalogun\Documents\GitHub\AfroTada new website code\img\Previous page.svg", "XML", 0, 0, 6, 0, 0, 0, 1, 7
"c:\Users\OlabayoBalogun\Documents\GitHub\AfroTada new website code\img\Rwanda flag.svg", "XML", 0, 0, 8, 0, 0, 0, 1, 9
"c:\Users\OlabayoBalogun\Documents\GitHub\AfroTada new website code\img\Search icon.svg", "XML", 0, 0, 7, 0, 0, 0, 1, 8
"c:\Users\OlabayoBalogun\Documents\GitHub\AfroTada new website code\img\Seychelles flag.svg", "XML", 0, 0, 8, 0, 0, 0, 1, 9
"c:\Users\OlabayoBalogun\Documents\GitHub\AfroTada new website code\img\Sierra Leone flag.svg", "XML", 0, 0, 8, 0, 0, 0, 1, 9
"c:\Users\OlabayoBalogun\Documents\GitHub\AfroTada new website code\img\Somalia.svg", "XML", 0, 0, 8, 0, 0, 0, 1, 9
"c:\Users\OlabayoBalogun\Documents\GitHub\AfroTada new website code\img\South Africa flag.svg", "XML", 0, 0, 8, 0, 0, 0, 1, 9
"c:\Users\OlabayoBalogun\Documents\GitHub\AfroTada new website code\img\South Sudan flag.svg", "XML", 0, 0, 8, 0, 0, 0, 1, 9
"c:\Users\OlabayoBalogun\Documents\GitHub\AfroTada new website code\img\Sub.svg", "XML", 0, 0, 7, 0, 0, 0, 1, 8
"c:\Users\OlabayoBalogun\Documents\GitHub\AfroTada new website code\img\Sudan flag.svg", "XML", 0, 0, 8, 0, 0, 0, 1, 9
"c:\Users\OlabayoBalogun\Documents\GitHub\AfroTada new website code\img\Sénégal flag.svg", "XML", 0, 0, 8, 0, 0, 0, 1, 9
"c:\Users\OlabayoBalogun\Documents\GitHub\AfroTada new website code\img\Tanzania flag.svg", "XML", 0, 0, 8, 0, 0, 0, 1, 9
"c:\Users\OlabayoBalogun\Documents\GitHub\AfroTada new website code\img\Togo flag.svg", "XML", 0, 0, 8, 0, 0, 0, 1, 9
"c:\Users\OlabayoBalogun\Documents\GitHub\AfroTada new website code\img\Tunisia flag.svg", "XML", 0, 0, 8, 0, 0, 0, 1, 9
"c:\Users\OlabayoBalogun\Documents\GitHub\AfroTada new website code\img\Uganda flag.svg", "XML", 0, 0, 8, 0, 0, 0, 1, 9
"c:\Users\OlabayoBalogun\Documents\GitHub\AfroTada new website code\img\Zambia.svg", "XML", 0, 0, 8, 0, 0, 0, 1, 9
"c:\Users\OlabayoBalogun\Documents\GitHub\AfroTada new website code\img\Zimbabwe.svg", "XML", 0, 0, 8, 0, 0, 0, 1, 9
"c:\Users\OlabayoBalogun\Documents\GitHub\AfroTada new website code\img\africanBooks.svg", "XML", 0, 0, 1, 0, 0, 0, 0, 1
"c:\Users\OlabayoBalogun\Documents\GitHub\AfroTada new website code\img\africanCulture.svg", "XML", 0, 0, 1, 0, 0, 0, 0, 1
"c:\Users\OlabayoBalogun\Documents\GitHub\AfroTada new website code\img\africanDocumentaries.svg", "XML", 0, 0, 1, 0, 0, 0, 0, 1
"c:\Users\OlabayoBalogun\Documents\GitHub\AfroTada new website code\img\africanFood.svg", "XML", 0, 0, 1, 0, 0, 0, 0, 1
"c:\Users\OlabayoBalogun\Documents\GitHub\AfroTada new website code\img\africanHistoricalSites.svg", "XML", 0, 0, 1, 0, 0, 0, 0, 1
"c:\Users\OlabayoBalogun\Documents\GitHub\AfroTada new website code\img\africanNaturalResources.svg", "XML", 0, 0, 1, 0, 0, 0, 0, 1
"c:\Users\OlabayoBalogun\Documents\GitHub\AfroTada new website code\img\africanPodcasts.svg", "XML", 0, 0, 1, 0, 0, 0, 0, 1
"c:\Users\OlabayoBalogun\Documents\GitHub\AfroTada new website code\img\africanPoets.svg", "XML", 0, 0, 1, 0, 0, 0, 0, 1
"c:\Users\OlabayoBalogun\Documents\GitHub\AfroTada new website code\img\africanProverbs.svg", "XML", 0, 0, 1, 0, 0, 0, 0, 1
"c:\Users\OlabayoBalogun\Documents\GitHub\AfroTada new website code\img\africanQuotes.svg", "XML", 0, 0, 1, 0, 0, 0, 0, 1
"c:\Users\OlabayoBalogun\Documents\GitHub\AfroTada new website code\img\africanUniversities.svg", "XML", 0, 0, 1, 0, 0, 0, 0, 1
"c:\Users\OlabayoBalogun\Documents\GitHub\AfroTada new website code\img\africanWriters.svg", "XML", 0, 0, 1, 0, 0, 0, 0, 1
"c:\Users\OlabayoBalogun\Documents\GitHub\AfroTada new website code\img\afrotadaLogo.svg", "XML", 0, 0, 1, 0, 0, 0, 0, 1
"c:\Users\OlabayoBalogun\Documents\GitHub\AfroTada new website code\img\algeriaFlag.svg", "XML", 0, 0, 13, 0, 0, 0, 1, 14
"c:\Users\OlabayoBalogun\Documents\GitHub\AfroTada new website code\img\angolaFlag.svg", "XML", 0, 0, 13, 0, 0, 0, 1, 14
"c:\Users\OlabayoBalogun\Documents\GitHub\AfroTada new website code\img\arrow-right.svg", "XML", 0, 0, 3, 0, 0, 0, 1, 4
"c:\Users\OlabayoBalogun\Documents\GitHub\AfroTada new website code\img\beninFlag.svg", "XML", 0, 0, 13, 0, 0, 0, 1, 14
"c:\Users\OlabayoBalogun\Documents\GitHub\AfroTada new website code\img\botswanaFlag.svg", "XML", 0, 0, 13, 0, 0, 0, 1, 14
"c:\Users\OlabayoBalogun\Documents\GitHub\AfroTada new website code\img\burkinafasoFlag.svg", "XML", 0, 0, 13, 0, 0, 0, 1, 14
"c:\Users\OlabayoBalogun\Documents\GitHub\AfroTada new website code\img\burundiFlag.svg", "XML", 0, 0, 13, 0, 0, 0, 1, 14
"c:\Users\OlabayoBalogun\Documents\GitHub\AfroTada new website code\img\cameroonFlag.svg", "XML", 0, 0, 13, 0, 0, 0, 1, 14
"c:\Users\OlabayoBalogun\Documents\GitHub\AfroTada new website code\img\capeverdeFlag.svg", "XML", 0, 0, 13, 0, 0, 0, 1, 14
"c:\Users\OlabayoBalogun\Documents\GitHub\AfroTada new website code\img\central African Republic flag.svg", "XML", 0, 0, 8, 0, 0, 0, 1, 9
"c:\Users\OlabayoBalogun\Documents\GitHub\AfroTada new website code\img\centralafricanrepublicFlag.svg", "XML", 0, 0, 13, 0, 0, 0, 1, 14
"c:\Users\OlabayoBalogun\Documents\GitHub\AfroTada new website code\img\chadFlag.svg", "XML", 0, 0, 13, 0, 0, 0, 1, 14
"c:\Users\OlabayoBalogun\Documents\GitHub\AfroTada new website code\img\circled up arrow.svg", "XML", 0, 0, 3, 0, 0, 0, 1, 4
"c:\Users\OlabayoBalogun\Documents\GitHub\AfroTada new website code\img\close.svg", "XML", 0, 0, 6, 0, 0, 0, 1, 7
"c:\Users\OlabayoBalogun\Documents\GitHub\AfroTada new website code\img\comorosFlag.svg", "XML", 0, 0, 13, 0, 0, 0, 1, 14
"c:\Users\OlabayoBalogun\Documents\GitHub\AfroTada new website code\img\coted'ivoireFlag.svg", "XML", 0, 0, 13, 0, 0, 0, 1, 14
"c:\Users\OlabayoBalogun\Documents\GitHub\AfroTada new website code\img\djiboutiFlag.svg", "XML", 0, 0, 13, 0, 0, 0, 1, 14
"c:\Users\OlabayoBalogun\Documents\GitHub\AfroTada new website code\img\drcongoFlag.svg", "XML", 0, 0, 13, 0, 0, 0, 1, 14
"c:\Users\OlabayoBalogun\Documents\GitHub\AfroTada new website code\img\education.svg", "XML", 0, 0, 35, 0, 0, 0, 1, 36
"c:\Users\OlabayoBalogun\Documents\GitHub\AfroTada new website code\img\egyptFlag.svg", "XML", 0, 0, 13, 0, 0, 0, 1, 14
"c:\Users\OlabayoBalogun\Documents\GitHub\AfroTada new website code\img\equatorialguineaFlag.svg", "XML", 0, 0, 13, 0, 0, 0, 1, 14
"c:\Users\OlabayoBalogun\Documents\GitHub\AfroTada new website code\img\eritreaFlag.svg", "XML", 0, 0, 13, 0, 0, 0, 1, 14
"c:\Users\OlabayoBalogun\Documents\GitHub\AfroTada new website code\img\eswatini flag.svg", "XML", 0, 0, 8, 0, 0, 0, 1, 9
"c:\Users\OlabayoBalogun\Documents\GitHub\AfroTada new website code\img\eswatiniFlag.svg", "XML", 0, 0, 13, 0, 0, 0, 1, 14
"c:\Users\OlabayoBalogun\Documents\GitHub\AfroTada new website code\img\ethiopiaFlag.svg", "XML", 0, 0, 13, 0, 0, 0, 1, 14
"c:\Users\OlabayoBalogun\Documents\GitHub\AfroTada new website code\img\female.svg", "XML", 0, 0, 8, 0, 0, 0, 1, 9
"c:\Users\OlabayoBalogun\Documents\GitHub\AfroTada new website code\img\gabonFlag.svg", "XML", 0, 0, 13, 0, 0, 0, 1, 14
"c:\Users\OlabayoBalogun\Documents\GitHub\AfroTada new website code\img\gambiaFlag.svg", "XML", 0, 0, 13, 0, 0, 0, 1, 14
"c:\Users\OlabayoBalogun\Documents\GitHub\AfroTada new website code\img\ghanaFlag.svg", "XML", 0, 0, 13, 0, 0, 0, 1, 14
"c:\Users\OlabayoBalogun\Documents\GitHub\AfroTada new website code\img\guineaFlag.svg", "XML", 0, 0, 13, 0, 0, 0, 1, 14
"c:\Users\OlabayoBalogun\Documents\GitHub\AfroTada new website code\img\guineabissauFlag.svg", "XML", 0, 0, 13, 0, 0, 0, 1, 14
"c:\Users\OlabayoBalogun\Documents\GitHub\AfroTada new website code\img\kenyaFlag.svg", "XML", 0, 0, 13, 0, 0, 0, 1, 14
"c:\Users\OlabayoBalogun\Documents\GitHub\AfroTada new website code\img\kinini.svg", "XML", 0, 0, 8, 0, 0, 0, 1, 9
"c:\Users\OlabayoBalogun\Documents\GitHub\AfroTada new website code\img\lesothoFlag.svg", "XML", 0, 0, 13, 0, 0, 0, 1, 14
"c:\Users\OlabayoBalogun\Documents\GitHub\AfroTada new website code\img\lewis.svg", "XML", 0, 0, 8, 0, 0, 0, 1, 9
"c:\Users\OlabayoBalogun\Documents\GitHub\AfroTada new website code\img\liberiaFlag.svg", "XML", 0, 0, 13, 0, 0, 0, 1, 14
"c:\Users\OlabayoBalogun\Documents\GitHub\AfroTada new website code\img\linkedin.svg", "XML", 0, 0, 20, 0, 0, 0, 1, 21
"c:\Users\OlabayoBalogun\Documents\GitHub\AfroTada new website code\img\lybia flag.svg", "XML", 0, 0, 8, 0, 0, 0, 1, 9
"c:\Users\OlabayoBalogun\Documents\GitHub\AfroTada new website code\img\lybiaFlag.svg", "XML", 0, 0, 13, 0, 0, 0, 1, 14
"c:\Users\OlabayoBalogun\Documents\GitHub\AfroTada new website code\img\madagascarFlag.svg", "XML", 0, 0, 13, 0, 0, 0, 1, 14
"c:\Users\OlabayoBalogun\Documents\GitHub\AfroTada new website code\img\malawi flag.svg", "XML", 0, 0, 8, 0, 0, 0, 1, 9
"c:\Users\OlabayoBalogun\Documents\GitHub\AfroTada new website code\img\malawiFlag.svg", "XML", 0, 0, 13, 0, 0, 0, 1, 14
"c:\Users\OlabayoBalogun\Documents\GitHub\AfroTada new website code\img\male.svg", "XML", 0, 0, 8, 0, 0, 0, 1, 9
"c:\Users\OlabayoBalogun\Documents\GitHub\AfroTada new website code\img\maliFlag.svg", "XML", 0, 0, 13, 0, 0, 0, 1, 14
"c:\Users\OlabayoBalogun\Documents\GitHub\AfroTada new website code\img\mauritaniaFlag.svg", "XML", 0, 0, 13, 0, 0, 0, 1, 14
"c:\Users\OlabayoBalogun\Documents\GitHub\AfroTada new website code\img\mauritiusFlag.svg", "XML", 0, 0, 13, 0, 0, 0, 1, 14
"c:\Users\OlabayoBalogun\Documents\GitHub\AfroTada new website code\img\moroccoFlag.svg", "XML", 0, 0, 13, 0, 0, 0, 1, 14
"c:\Users\OlabayoBalogun\Documents\GitHub\AfroTada new website code\img\mozambiqueFlag.svg", "XML", 0, 0, 13, 0, 0, 0, 1, 14
"c:\Users\OlabayoBalogun\Documents\GitHub\AfroTada new website code\img\namibiaFlag.svg", "XML", 0, 0, 13, 0, 0, 0, 1, 14
"c:\Users\OlabayoBalogun\Documents\GitHub\AfroTada new website code\img\nifemi.svg", "XML", 0, 0, 8, 0, 0, 0, 1, 9
"c:\Users\OlabayoBalogun\Documents\GitHub\AfroTada new website code\img\niger flag.svg", "XML", 0, 0, 8, 0, 0, 0, 1, 9
"c:\Users\OlabayoBalogun\Documents\GitHub\AfroTada new website code\img\nigerFlag.svg", "XML", 0, 0, 13, 0, 0, 0, 1, 14
"c:\Users\OlabayoBalogun\Documents\GitHub\AfroTada new website code\img\nigeriaFlag.svg", "XML", 0, 0, 13, 0, 0, 0, 1, 14
"c:\Users\OlabayoBalogun\Documents\GitHub\AfroTada new website code\img\opeyemiAdetifa.svg", "XML", 0, 0, 8, 0, 0, 0, 1, 9
"c:\Users\OlabayoBalogun\Documents\GitHub\AfroTada new website code\img\philaDyasi.svg", "XML", 0, 0, 8, 0, 0, 0, 1, 9
"c:\Users\OlabayoBalogun\Documents\GitHub\AfroTada new website code\img\republic of congo flag.svg", "XML", 0, 0, 8, 0, 0, 0, 1, 9
"c:\Users\OlabayoBalogun\Documents\GitHub\AfroTada new website code\img\republicofcongoFlag.svg", "XML", 0, 0, 13, 0, 0, 0, 1, 14
"c:\Users\OlabayoBalogun\Documents\GitHub\AfroTada new website code\img\rwandaFlag.svg", "XML", 0, 0, 13, 0, 0, 0, 1, 14
"c:\Users\OlabayoBalogun\Documents\GitHub\AfroTada new website code\img\sao tome and principe flag.svg", "XML", 0, 0, 8, 0, 0, 0, 1, 9
"c:\Users\OlabayoBalogun\Documents\GitHub\AfroTada new website code\img\saotomeandprincipeFlag.svg", "XML", 0, 0, 13, 0, 0, 0, 1, 14
"c:\Users\OlabayoBalogun\Documents\GitHub\AfroTada new website code\img\senegalFlag.svg", "XML", 0, 0, 13, 0, 0, 0, 1, 14
"c:\Users\OlabayoBalogun\Documents\GitHub\AfroTada new website code\img\separating elipse.svg", "XML", 0, 0, 3, 0, 0, 0, 1, 4
"c:\Users\OlabayoBalogun\Documents\GitHub\AfroTada new website code\img\seychellesFlag.svg", "XML", 0, 0, 13, 0, 0, 0, 1, 14
"c:\Users\OlabayoBalogun\Documents\GitHub\AfroTada new website code\img\sierraleoneFlag.svg", "XML", 0, 0, 13, 0, 0, 0, 1, 14
"c:\Users\OlabayoBalogun\Documents\GitHub\AfroTada new website code\img\simotwo.svg", "XML", 0, 0, 8, 0, 0, 0, 1, 9
"c:\Users\OlabayoBalogun\Documents\GitHub\AfroTada new website code\img\somaliaFlag.svg", "XML", 0, 0, 13, 0, 0, 0, 1, 14
"c:\Users\OlabayoBalogun\Documents\GitHub\AfroTada new website code\img\southafricaFlag.svg", "XML", 0, 0, 13, 0, 0, 0, 1, 14
"c:\Users\OlabayoBalogun\Documents\GitHub\AfroTada new website code\img\southsudanFlag.svg", "XML", 0, 0, 13, 0, 0, 0, 1, 14
"c:\Users\OlabayoBalogun\Documents\GitHub\AfroTada new website code\img\sudanFlag.svg", "XML", 0, 0, 13, 0, 0, 0, 1, 14
"c:\Users\OlabayoBalogun\Documents\GitHub\AfroTada new website code\img\tafadzwaMakara.svg", "XML", 0, 0, 8, 0, 0, 0, 1, 9
"c:\Users\OlabayoBalogun\Documents\GitHub\AfroTada new website code\img\tag.svg", "XML", 0, 0, 12, 0, 0, 0, 1, 13
"c:\Users\OlabayoBalogun\Documents\GitHub\AfroTada new website code\img\tanzaniaFlag.svg", "XML", 0, 0, 13, 0, 0, 0, 1, 14
"c:\Users\OlabayoBalogun\Documents\GitHub\AfroTada new website code\img\togoFlag.svg", "XML", 0, 0, 13, 0, 0, 0, 1, 14
"c:\Users\OlabayoBalogun\Documents\GitHub\AfroTada new website code\img\triangle.svg", "XML", 0, 0, 3, 0, 0, 0, 1, 4
"c:\Users\OlabayoBalogun\Documents\GitHub\AfroTada new website code\img\tunisiaFlag.svg", "XML", 0, 0, 13, 0, 0, 0, 1, 14
"c:\Users\OlabayoBalogun\Documents\GitHub\AfroTada new website code\img\ugandaFlag.svg", "XML", 0, 0, 13, 0, 0, 0, 1, 14
"c:\Users\OlabayoBalogun\Documents\GitHub\AfroTada new website code\img\zainab olaowo.svg", "XML", 0, 0, 8, 0, 0, 0, 1, 9
"c:\Users\OlabayoBalogun\Documents\GitHub\AfroTada new website code\img\zainab-olaitan.svg", "XML", 0, 0, 8, 0, 0, 0, 1, 9
"c:\Users\OlabayoBalogun\Documents\GitHub\AfroTada new website code\img\zainabOlaitan.svg", "XML", 0, 0, 8, 0, 0, 0, 1, 9
"c:\Users\OlabayoBalogun\Documents\GitHub\AfroTada new website code\img\zainabOlaowo.svg", "XML", 0, 0, 8, 0, 0, 0, 1, 9
"c:\Users\OlabayoBalogun\Documents\GitHub\AfroTada new website code\img\zambiaFlag.svg", "XML", 0, 0, 13, 0, 0, 0, 1, 14
"c:\Users\OlabayoBalogun\Documents\GitHub\AfroTada new website code\img\zimbabweFlag.svg", "XML", 0, 0, 13, 0, 0, 0, 1, 14
"c:\Users\OlabayoBalogun\Documents\GitHub\AfroTada new website code\index.html", "HTML", 201, 0, 0, 0, 0, 26, 13, 240
"c:\Users\OlabayoBalogun\Documents\GitHub\AfroTada new website code\kenya.html", "HTML", 157, 0, 0, 0, 0, 8, 3, 168
"c:\Users\OlabayoBalogun\Documents\GitHub\AfroTada new website code\kenyaBooks.html", "HTML", 75, 0, 0, 0, 0, 8, 2, 85
"c:\Users\OlabayoBalogun\Documents\GitHub\AfroTada new website code\kenyaCulture.html", "HTML", 75, 0, 0, 0, 0, 8, 2, 85
"c:\Users\OlabayoBalogun\Documents\GitHub\AfroTada new website code\kenyaDocumentaries.html", "HTML", 75, 0, 0, 0, 0, 8, 2, 85
"c:\Users\OlabayoBalogun\Documents\GitHub\AfroTada new website code\kenyaFood.html", "HTML", 75, 0, 0, 0, 0, 8, 2, 85
"c:\Users\OlabayoBalogun\Documents\GitHub\AfroTada new website code\kenyaHistoricalSites.html", "HTML", 75, 0, 0, 0, 0, 8, 2, 85
"c:\Users\OlabayoBalogun\Documents\GitHub\AfroTada new website code\kenyaNaturalResources.html", "HTML", 75, 0, 0, 0, 0, 8, 2, 85
"c:\Users\OlabayoBalogun\Documents\GitHub\AfroTada new website code\kenyaPodcasts.html", "HTML", 75, 0, 0, 0, 0, 8, 2, 85
"c:\Users\OlabayoBalogun\Documents\GitHub\AfroTada new website code\kenyaPoets.html", "HTML", 75, 0, 0, 0, 0, 8, 2, 85
"c:\Users\OlabayoBalogun\Documents\GitHub\AfroTada new website code\kenyaProverbs.html", "HTML", 75, 0, 0, 0, 0, 8, 2, 85
"c:\Users\OlabayoBalogun\Documents\GitHub\AfroTada new website code\kenyaUniversities.html", "HTML", 75, 0, 0, 0, 0, 8, 2, 85
"c:\Users\OlabayoBalogun\Documents\GitHub\AfroTada new website code\kenyaWriters.html", "HTML", 75, 0, 0, 0, 0, 8, 2, 85
"c:\Users\OlabayoBalogun\Documents\GitHub\AfroTada new website code\lesotho.html", "HTML", 157, 0, 0, 0, 0, 8, 3, 168
"c:\Users\OlabayoBalogun\Documents\GitHub\AfroTada new website code\lesothoBooks.html", "HTML", 75, 0, 0, 0, 0, 8, 2, 85
"c:\Users\OlabayoBalogun\Documents\GitHub\AfroTada new website code\lesothoCulture.html", "HTML", 75, 0, 0, 0, 0, 8, 2, 85
"c:\Users\OlabayoBalogun\Documents\GitHub\AfroTada new website code\lesothoDocumentaries.html", "HTML", 75, 0, 0, 0, 0, 8, 2, 85
"c:\Users\OlabayoBalogun\Documents\GitHub\AfroTada new website code\lesothoFood.html", "HTML", 75, 0, 0, 0, 0, 8, 2, 85
"c:\Users\OlabayoBalogun\Documents\GitHub\AfroTada new website code\lesothoHistoricalSites.html", "HTML", 75, 0, 0, 0, 0, 8, 2, 85
"c:\Users\OlabayoBalogun\Documents\GitHub\AfroTada new website code\lesothoNaturalResources.html", "HTML", 75, 0, 0, 0, 0, 8, 2, 85
"c:\Users\OlabayoBalogun\Documents\GitHub\AfroTada new website code\lesothoPodcasts.html", "HTML", 75, 0, 0, 0, 0, 8, 2, 85
"c:\Users\OlabayoBalogun\Documents\GitHub\AfroTada new website code\lesothoPoets.html", "HTML", 75, 0, 0, 0, 0, 8, 2, 85
"c:\Users\OlabayoBalogun\Documents\GitHub\AfroTada new website code\lesothoProverbs.html", "HTML", 75, 0, 0, 0, 0, 8, 2, 85
"c:\Users\OlabayoBalogun\Documents\GitHub\AfroTada new website code\lesothoQuotes.html", "HTML", 75, 0, 0, 0, 0, 8, 2, 85
"c:\Users\OlabayoBalogun\Documents\GitHub\AfroTada new website code\lesothoUniversities.html", "HTML", 75, 0, 0, 0, 0, 8, 2, 85
"c:\Users\OlabayoBalogun\Documents\GitHub\AfroTada new website code\lesothoWriters.html", "HTML", 75, 0, 0, 0, 0, 8, 2, 85
"c:\Users\OlabayoBalogun\Documents\GitHub\AfroTada new website code\liberia.html", "HTML", 157, 0, 0, 0, 0, 8, 3, 168
"c:\Users\OlabayoBalogun\Documents\GitHub\AfroTada new website code\liberiaBooks.html", "HTML", 75, 0, 0, 0, 0, 8, 2, 85
"c:\Users\OlabayoBalogun\Documents\GitHub\AfroTada new website code\liberiaCulture.html", "HTML", 75, 0, 0, 0, 0, 8, 2, 85
"c:\Users\OlabayoBalogun\Documents\GitHub\AfroTada new website code\liberiaDocumentaries.html", "HTML", 75, 0, 0, 0, 0, 8, 2, 85
"c:\Users\OlabayoBalogun\Documents\GitHub\AfroTada new website code\liberiaFood.html", "HTML", 75, 0, 0, 0, 0, 8, 2, 85
"c:\Users\OlabayoBalogun\Documents\GitHub\AfroTada new website code\liberiaHistoricalSites.html", "HTML", 75, 0, 0, 0, 0, 8, 2, 85
"c:\Users\OlabayoBalogun\Documents\GitHub\AfroTada new website code\liberiaNaturalResources.html", "HTML", 75, 0, 0, 0, 0, 8, 2, 85
"c:\Users\OlabayoBalogun\Documents\GitHub\AfroTada new website code\liberiaPodcasts.html", "HTML", 75, 0, 0, 0, 0, 8, 2, 85
"c:\Users\OlabayoBalogun\Documents\GitHub\AfroTada new website code\liberiaPoets.html", "HTML", 75, 0, 0, 0, 0, 8, 2, 85
"c:\Users\OlabayoBalogun\Documents\GitHub\AfroTada new website code\liberiaProverbs.html", "HTML", 75, 0, 0, 0, 0, 8, 2, 85
"c:\Users\OlabayoBalogun\Documents\GitHub\AfroTada new website code\liberiaQuotes.html", "HTML", 75, 0, 0, 0, 0, 8, 2, 85
"c:\Users\OlabayoBalogun\Documents\GitHub\AfroTada new website code\liberiaUniversities.html", "HTML", 75, 0, 0, 0, 0, 8, 2, 85
"c:\Users\OlabayoBalogun\Documents\GitHub\AfroTada new website code\liberiaWriters.html", "HTML", 75, 0, 0, 0, 0, 8, 2, 85
"c:\Users\OlabayoBalogun\Documents\GitHub\AfroTada new website code\libya.html", "HTML", 157, 0, 0, 0, 0, 8, 3, 168
"c:\Users\OlabayoBalogun\Documents\GitHub\AfroTada new website code\libyaBooks.html", "HTML", 75, 0, 0, 0, 0, 8, 2, 85
"c:\Users\OlabayoBalogun\Documents\GitHub\AfroTada new website code\libyaCulture.html", "HTML", 75, 0, 0, 0, 0, 8, 2, 85
"c:\Users\OlabayoBalogun\Documents\GitHub\AfroTada new website code\libyaDocumentaries.html", "HTML", 75, 0, 0, 0, 0, 8, 2, 85
"c:\Users\OlabayoBalogun\Documents\GitHub\AfroTada new website code\libyaFood.html", "HTML", 75, 0, 0, 0, 0, 8, 2, 85
"c:\Users\OlabayoBalogun\Documents\GitHub\AfroTada new website code\libyaHistoricalSites.html", "HTML", 75, 0, 0, 0, 0, 8, 2, 85
"c:\Users\OlabayoBalogun\Documents\GitHub\AfroTada new website code\libyaNaturalResources.html", "HTML", 75, 0, 0, 0, 0, 8, 2, 85
"c:\Users\OlabayoBalogun\Documents\GitHub\AfroTada new website code\libyaPodcasts.html", "HTML", 75, 0, 0, 0, 0, 8, 2, 85
"c:\Users\OlabayoBalogun\Documents\GitHub\AfroTada new website code\libyaPoets.html", "HTML", 75, 0, 0, 0, 0, 8, 2, 85
"c:\Users\OlabayoBalogun\Documents\GitHub\AfroTada new website code\libyaProverbs.html", "HTML", 75, 0, 0, 0, 0, 8, 2, 85
"c:\Users\OlabayoBalogun\Documents\GitHub\AfroTada new website code\libyaQuotes.html", "HTML", 75, 0, 0, 0, 0, 8, 2, 85
"c:\Users\OlabayoBalogun\Documents\GitHub\AfroTada new website code\libyaUniversities.html", "HTML", 75, 0, 0, 0, 0, 8, 2, 85
"c:\Users\OlabayoBalogun\Documents\GitHub\AfroTada new website code\libyaWriters.html", "HTML", 75, 0, 0, 0, 0, 8, 2, 85
"c:\Users\OlabayoBalogun\Documents\GitHub\AfroTada new website code\madagascar.html", "HTML", 157, 0, 0, 0, 0, 8, 3, 168
"c:\Users\OlabayoBalogun\Documents\GitHub\AfroTada new website code\madagascarBooks.html", "HTML", 75, 0, 0, 0, 0, 8, 2, 85
"c:\Users\OlabayoBalogun\Documents\GitHub\AfroTada new website code\madagascarCulture.html", "HTML", 75, 0, 0, 0, 0, 8, 2, 85
"c:\Users\OlabayoBalogun\Documents\GitHub\AfroTada new website code\madagascarDocumentaries.html", "HTML", 75, 0, 0, 0, 0, 8, 2, 85
"c:\Users\OlabayoBalogun\Documents\GitHub\AfroTada new website code\madagascarFood.html", "HTML", 75, 0, 0, 0, 0, 8, 2, 85
"c:\Users\OlabayoBalogun\Documents\GitHub\AfroTada new website code\madagascarHistoricalSites.html", "HTML", 75, 0, 0, 0, 0, 8, 2, 85
"c:\Users\OlabayoBalogun\Documents\GitHub\AfroTada new website code\madagascarNaturalResources.html", "HTML", 75, 0, 0, 0, 0, 8, 2, 85
"c:\Users\OlabayoBalogun\Documents\GitHub\AfroTada new website code\madagascarPodcasts.html", "HTML", 75, 0, 0, 0, 0, 8, 2, 85
"c:\Users\OlabayoBalogun\Documents\GitHub\AfroTada new website code\madagascarPoets.html", "HTML", 75, 0, 0, 0, 0, 8, 2, 85
"c:\Users\OlabayoBalogun\Documents\GitHub\AfroTada new website code\madagascarProverbs.html", "HTML", 76, 0, 0, 0, 0, 8, 2, 86
"c:\Users\OlabayoBalogun\Documents\GitHub\AfroTada new website code\madagascarQuotes.html", "HTML", 75, 0, 0, 0, 0, 8, 2, 85
"c:\Users\OlabayoBalogun\Documents\GitHub\AfroTada new website code\madagascarUniversities.html", "HTML", 75, 0, 0, 0, 0, 8, 2, 85
"c:\Users\OlabayoBalogun\Documents\GitHub\AfroTada new website code\madagascarWriters.html", "HTML", 75, 0, 0, 0, 0, 8, 2, 85
"c:\Users\OlabayoBalogun\Documents\GitHub\AfroTada new website code\malawi.html", "HTML", 157, 0, 0, 0, 0, 8, 3, 168
"c:\Users\OlabayoBalogun\Documents\GitHub\AfroTada new website code\malawiBooks.html", "HTML", 75, 0, 0, 0, 0, 8, 2, 85
"c:\Users\OlabayoBalogun\Documents\GitHub\AfroTada new website code\malawiCulture.html", "HTML", 75, 0, 0, 0, 0, 8, 2, 85
"c:\Users\OlabayoBalogun\Documents\GitHub\AfroTada new website code\malawiDocumentaries.html", "HTML", 75, 0, 0, 0, 0, 8, 2, 85
"c:\Users\OlabayoBalogun\Documents\GitHub\AfroTada new website code\malawiFood.html", "HTML", 75, 0, 0, 0, 0, 8, 2, 85
"c:\Users\OlabayoBalogun\Documents\GitHub\AfroTada new website code\malawiHistoricalSites.html", "HTML", 75, 0, 0, 0, 0, 8, 2, 85
"c:\Users\OlabayoBalogun\Documents\GitHub\AfroTada new website code\malawiNaturalResources.html", "HTML", 75, 0, 0, 0, 0, 8, 2, 85
"c:\Users\OlabayoBalogun\Documents\GitHub\AfroTada new website code\malawiPodcasts.html", "HTML", 75, 0, 0, 0, 0, 8, 2, 85
"c:\Users\OlabayoBalogun\Documents\GitHub\AfroTada new website code\malawiPoets.html", "HTML", 75, 0, 0, 0, 0, 8, 2, 85
"c:\Users\OlabayoBalogun\Documents\GitHub\AfroTada new website code\malawiProverbs.html", "HTML", 75, 0, 0, 0, 0, 8, 2, 85
"c:\Users\OlabayoBalogun\Documents\GitHub\AfroTada new website code\malawiQuotes.html", "HTML", 75, 0, 0, 0, 0, 8, 2, 85
"c:\Users\OlabayoBalogun\Documents\GitHub\AfroTada new website code\malawiUniversities.html", "HTML", 75, 0, 0, 0, 0, 8, 2, 85
"c:\Users\OlabayoBalogun\Documents\GitHub\AfroTada new website code\malawiWriters.html", "HTML", 75, 0, 0, 0, 0, 8, 2, 85
"c:\Users\OlabayoBalogun\Documents\GitHub\AfroTada new website code\mali.html", "HTML", 157, 0, 0, 0, 0, 8, 3, 168
"c:\Users\OlabayoBalogun\Documents\GitHub\AfroTada new website code\maliBooks.html", "HTML", 75, 0, 0, 0, 0, 8, 2, 85
"c:\Users\OlabayoBalogun\Documents\GitHub\AfroTada new website code\maliCulture.html", "HTML", 75, 0, 0, 0, 0, 8, 2, 85
"c:\Users\OlabayoBalogun\Documents\GitHub\AfroTada new website code\maliDocumentaries.html", "HTML", 75, 0, 0, 0, 0, 8, 2, 85
"c:\Users\OlabayoBalogun\Documents\GitHub\AfroTada new website code\maliFood.html", "HTML", 75, 0, 0, 0, 0, 8, 2, 85
"c:\Users\OlabayoBalogun\Documents\GitHub\AfroTada new website code\maliHistoricalSites.html", "HTML", 75, 0, 0, 0, 0, 8, 2, 85
"c:\Users\OlabayoBalogun\Documents\GitHub\AfroTada new website code\maliNaturalResources.html", "HTML", 75, 0, 0, 0, 0, 8, 2, 85
"c:\Users\OlabayoBalogun\Documents\GitHub\AfroTada new website code\maliPodcasts.html", "HTML", 75, 0, 0, 0, 0, 8, 2, 85
"c:\Users\OlabayoBalogun\Documents\GitHub\AfroTada new website code\maliPoets.html", "HTML", 75, 0, 0, 0, 0, 8, 2, 85
"c:\Users\OlabayoBalogun\Documents\GitHub\AfroTada new website code\maliProverbs.html", "HTML", 75, 0, 0, 0, 0, 8, 2, 85
"c:\Users\OlabayoBalogun\Documents\GitHub\AfroTada new website code\maliQuotes.html", "HTML", 75, 0, 0, 0, 0, 8, 2, 85
"c:\Users\OlabayoBalogun\Documents\GitHub\AfroTada new website code\maliUniversities.html", "HTML", 75, 0, 0, 0, 0, 8, 2, 85
"c:\Users\OlabayoBalogun\Documents\GitHub\AfroTada new website code\maliWriters.html", "HTML", 75, 0, 0, 0, 0, 8, 2, 85
"c:\Users\OlabayoBalogun\Documents\GitHub\AfroTada new website code\mauritania.html", "HTML", 157, 0, 0, 0, 0, 8, 3, 168
"c:\Users\OlabayoBalogun\Documents\GitHub\AfroTada new website code\mauritaniaBooks.html", "HTML", 75, 0, 0, 0, 0, 8, 2, 85
"c:\Users\OlabayoBalogun\Documents\GitHub\AfroTada new website code\mauritaniaCulture.html", "HTML", 75, 0, 0, 0, 0, 8, 2, 85
"c:\Users\OlabayoBalogun\Documents\GitHub\AfroTada new website code\mauritaniaDocumentaries.html", "HTML", 75, 0, 0, 0, 0, 8, 2, 85
"c:\Users\OlabayoBalogun\Documents\GitHub\AfroTada new website code\mauritaniaFood.html", "HTML", 75, 0, 0, 0, 0, 8, 2, 85
"c:\Users\OlabayoBalogun\Documents\GitHub\AfroTada new website code\mauritaniaHistoricalSites.html", "HTML", 75, 0, 0, 0, 0, 8, 2, 85
"c:\Users\OlabayoBalogun\Documents\GitHub\AfroTada new website code\mauritaniaNaturalResources.html", "HTML", 75, 0, 0, 0, 0, 8, 2, 85
"c:\Users\OlabayoBalogun\Documents\GitHub\AfroTada new website code\mauritaniaPoets.html", "HTML", 75, 0, 0, 0, 0, 8, 2, 85
"c:\Users\OlabayoBalogun\Documents\GitHub\AfroTada new website code\mauritaniaProverbs.html", "HTML", 75, 0, 0, 0, 0, 8, 2, 85
"c:\Users\OlabayoBalogun\Documents\GitHub\AfroTada new website code\mauritaniaQuotes.html", "HTML", 75, 0, 0, 0, 0, 8, 2, 85
"c:\Users\OlabayoBalogun\Documents\GitHub\AfroTada new website code\mauritaniaUniversities.html", "HTML", 75, 0, 0, 0, 0, 8, 2, 85
"c:\Users\OlabayoBalogun\Documents\GitHub\AfroTada new website code\mauritaniaWriters.html", "HTML", 75, 0, 0, 0, 0, 8, 2, 85
"c:\Users\OlabayoBalogun\Documents\GitHub\AfroTada new website code\mauritius.html", "HTML", 157, 0, 0, 0, 0, 8, 3, 168
"c:\Users\OlabayoBalogun\Documents\GitHub\AfroTada new website code\mauritiusBooks.html", "HTML", 75, 0, 0, 0, 0, 8, 2, 85
"c:\Users\OlabayoBalogun\Documents\GitHub\AfroTada new website code\mauritiusCulture.html", "HTML", 75, 0, 0, 0, 0, 8, 2, 85
"c:\Users\OlabayoBalogun\Documents\GitHub\AfroTada new website code\mauritiusDocumentaries.html", "HTML", 75, 0, 0, 0, 0, 8, 2, 85
"c:\Users\OlabayoBalogun\Documents\GitHub\AfroTada new website code\mauritiusFood.html", "HTML", 75, 0, 0, 0, 0, 8, 2, 85
"c:\Users\OlabayoBalogun\Documents\GitHub\AfroTada new website code\mauritiusHistoricalSites.html", "HTML", 75, 0, 0, 0, 0, 8, 2, 85
"c:\Users\OlabayoBalogun\Documents\GitHub\AfroTada new website code\mauritiusNaturalResources.html", "HTML", 75, 0, 0, 0, 0, 8, 2, 85
"c:\Users\OlabayoBalogun\Documents\GitHub\AfroTada new website code\mauritiusPodcasts.html", "HTML", 75, 0, 0, 0, 0, 8, 2, 85
"c:\Users\OlabayoBalogun\Documents\GitHub\AfroTada new website code\mauritiusPoets.html", "HTML", 75, 0, 0, 0, 0, 8, 2, 85
"c:\Users\OlabayoBalogun\Documents\GitHub\AfroTada new website code\mauritiusProverbs.html", "HTML", 75, 0, 0, 0, 0, 8, 2, 85
"c:\Users\OlabayoBalogun\Documents\GitHub\AfroTada new website code\mauritiusQuotes.html", "HTML", 75, 0, 0, 0, 0, 8, 2, 85
"c:\Users\OlabayoBalogun\Documents\GitHub\AfroTada new website code\mauritiusUniversities.html", "HTML", 75, 0, 0, 0, 0, 8, 2, 85
"c:\Users\OlabayoBalogun\Documents\GitHub\AfroTada new website code\mauritiusWriters.html", "HTML", 75, 0, 0, 0, 0, 8, 2, 85
"c:\Users\OlabayoBalogun\Documents\GitHub\AfroTada new website code\morocco.html", "HTML", 157, 0, 0, 0, 0, 8, 3, 168
"c:\Users\OlabayoBalogun\Documents\GitHub\AfroTada new website code\moroccoBooks.html", "HTML", 75, 0, 0, 0, 0, 8, 2, 85
"c:\Users\OlabayoBalogun\Documents\GitHub\AfroTada new website code\moroccoCulture.html", "HTML", 75, 0, 0, 0, 0, 8, 2, 85
"c:\Users\OlabayoBalogun\Documents\GitHub\AfroTada new website code\moroccoDocumentaries.html", "HTML", 75, 0, 0, 0, 0, 8, 2, 85
"c:\Users\OlabayoBalogun\Documents\GitHub\AfroTada new website code\moroccoFood.html", "HTML", 75, 0, 0, 0, 0, 8, 2, 85
"c:\Users\OlabayoBalogun\Documents\GitHub\AfroTada new website code\moroccoHistoricalSites.html", "HTML", 75, 0, 0, 0, 0, 8, 2, 85
"c:\Users\OlabayoBalogun\Documents\GitHub\AfroTada new website code\moroccoNaturalResources.html", "HTML", 75, 0, 0, 0, 0, 8, 2, 85
"c:\Users\OlabayoBalogun\Documents\GitHub\AfroTada new website code\moroccoPodcasts.html", "HTML", 75, 0, 0, 0, 0, 8, 2, 85
"c:\Users\OlabayoBalogun\Documents\GitHub\AfroTada new website code\moroccoPoets.html", "HTML", 75, 0, 0, 0, 0, 8, 2, 85
"c:\Users\OlabayoBalogun\Documents\GitHub\AfroTada new website code\moroccoProverbs.html", "HTML", 75, 0, 0, 0, 0, 8, 2, 85
"c:\Users\OlabayoBalogun\Documents\GitHub\AfroTada new website code\moroccoQuotes.html", "HTML", 75, 0, 0, 0, 0, 8, 2, 85
"c:\Users\OlabayoBalogun\Documents\GitHub\AfroTada new website code\moroccoUniversities.html", "HTML", 75, 0, 0, 0, 0, 8, 2, 85
"c:\Users\OlabayoBalogun\Documents\GitHub\AfroTada new website code\moroccoWriters.html", "HTML", 75, 0, 0, 0, 0, 8, 2, 85
"c:\Users\OlabayoBalogun\Documents\GitHub\AfroTada new website code\mozambique.html", "HTML", 157, 0, 0, 0, 0, 8, 3, 168
"c:\Users\OlabayoBalogun\Documents\GitHub\AfroTada new website code\mozambiqueBooks.html", "HTML", 75, 0, 0, 0, 0, 8, 3, 86
"c:\Users\OlabayoBalogun\Documents\GitHub\AfroTada new website code\mozambiqueCulture.html", "HTML", 75, 0, 0, 0, 0, 8, 2, 85
"c:\Users\OlabayoBalogun\Documents\GitHub\AfroTada new website code\mozambiqueDocumentaries.html", "HTML", 75, 0, 0, 0, 0, 8, 2, 85
"c:\Users\OlabayoBalogun\Documents\GitHub\AfroTada new website code\mozambiqueFood.html", "HTML", 75, 0, 0, 0, 0, 8, 2, 85
"c:\Users\OlabayoBalogun\Documents\GitHub\AfroTada new website code\mozambiqueHistoricalSites.html", "HTML", 75, 0, 0, 0, 0, 8, 2, 85
"c:\Users\OlabayoBalogun\Documents\GitHub\AfroTada new website code\mozambiqueNaturalResources.html", "HTML", 75, 0, 0, 0, 0, 8, 2, 85
"c:\Users\OlabayoBalogun\Documents\GitHub\AfroTada new website code\mozambiquePodcasts.html", "HTML", 75, 0, 0, 0, 0, 8, 2, 85
"c:\Users\OlabayoBalogun\Documents\GitHub\AfroTada new website code\mozambiquePoets.html", "HTML", 75, 0, 0, 0, 0, 8, 2, 85
"c:\Users\OlabayoBalogun\Documents\GitHub\AfroTada new website code\mozambiqueProverbs.html", "HTML", 75, 0, 0, 0, 0, 8, 2, 85
"c:\Users\OlabayoBalogun\Documents\GitHub\AfroTada new website code\mozambiqueQuotes.html", "HTML", 75, 0, 0, 0, 0, 8, 2, 85
"c:\Users\OlabayoBalogun\Documents\GitHub\AfroTada new website code\mozambiqueUniversities.html", "HTML", 75, 0, 0, 0, 0, 8, 2, 85
"c:\Users\OlabayoBalogun\Documents\GitHub\AfroTada new website code\mozambiqueWriters.html", "HTML", 75, 0, 0, 0, 0, 8, 2, 85
"c:\Users\OlabayoBalogun\Documents\GitHub\AfroTada new website code\namibia.html", "HTML", 157, 0, 0, 0, 0, 8, 3, 168
"c:\Users\OlabayoBalogun\Documents\GitHub\AfroTada new website code\namibiaBooks.html", "HTML", 75, 0, 0, 0, 0, 8, 2, 85
"c:\Users\OlabayoBalogun\Documents\GitHub\AfroTada new website code\namibiaCulture.html", "HTML", 75, 0, 0, 0, 0, 8, 2, 85
"c:\Users\OlabayoBalogun\Documents\GitHub\AfroTada new website code\namibiaDocumentaries.html", "HTML", 75, 0, 0, 0, 0, 8, 2, 85
"c:\Users\OlabayoBalogun\Documents\GitHub\AfroTada new website code\namibiaFood.html", "HTML", 75, 0, 0, 0, 0, 8, 2, 85
"c:\Users\OlabayoBalogun\Documents\GitHub\AfroTada new website code\namibiaHistoricalSites.html", "HTML", 75, 0, 0, 0, 0, 8, 2, 85
"c:\Users\OlabayoBalogun\Documents\GitHub\AfroTada new website code\namibiaNaturalResources.html", "HTML", 75, 0, 0, 0, 0, 8, 2, 85
"c:\Users\OlabayoBalogun\Documents\GitHub\AfroTada new website code\namibiaPodcasts.html", "HTML", 75, 0, 0, 0, 0, 8, 2, 85
"c:\Users\OlabayoBalogun\Documents\GitHub\AfroTada new website code\namibiaPoets.html", "HTML", 75, 0, 0, 0, 0, 8, 2, 85
"c:\Users\OlabayoBalogun\Documents\GitHub\AfroTada new website code\namibiaProverbs.html", "HTML", 75, 0, 0, 0, 0, 8, 2, 85
"c:\Users\OlabayoBalogun\Documents\GitHub\AfroTada new website code\namibiaQuotes.html", "HTML", 75, 0, 0, 0, 0, 8, 2, 85
"c:\Users\OlabayoBalogun\Documents\GitHub\AfroTada new website code\namibiaUniversities.html", "HTML", 75, 0, 0, 0, 0, 8, 2, 85
"c:\Users\OlabayoBalogun\Documents\GitHub\AfroTada new website code\namibiaWriters.html", "HTML", 75, 0, 0, 0, 0, 8, 2, 85
"c:\Users\OlabayoBalogun\Documents\GitHub\AfroTada new website code\niger.html", "HTML", 157, 0, 0, 0, 0, 8, 3, 168
"c:\Users\OlabayoBalogun\Documents\GitHub\AfroTada new website code\nigerBooks.html", "HTML", 75, 0, 0, 0, 0, 8, 2, 85
"c:\Users\OlabayoBalogun\Documents\GitHub\AfroTada new website code\nigerCulture.html", "HTML", 75, 0, 0, 0, 0, 8, 2, 85
"c:\Users\OlabayoBalogun\Documents\GitHub\AfroTada new website code\nigerDocumentaries.html", "HTML", 75, 0, 0, 0, 0, 8, 2, 85
"c:\Users\OlabayoBalogun\Documents\GitHub\AfroTada new website code\nigerFood.html", "HTML", 75, 0, 0, 0, 0, 8, 2, 85
"c:\Users\OlabayoBalogun\Documents\GitHub\AfroTada new website code\nigerHistoricalSites.html", "HTML", 75, 0, 0, 0, 0, 8, 2, 85
"c:\Users\OlabayoBalogun\Documents\GitHub\AfroTada new website code\nigerNaturalResources.html", "HTML", 75, 0, 0, 0, 0, 8, 2, 85
"c:\Users\OlabayoBalogun\Documents\GitHub\AfroTada new website code\nigerPodcasts.html", "HTML", 75, 0, 0, 0, 0, 8, 2, 85
"c:\Users\OlabayoBalogun\Documents\GitHub\AfroTada new website code\nigerPoets.html", "HTML", 76, 0, 0, 0, 0, 8, 2, 86
"c:\Users\OlabayoBalogun\Documents\GitHub\AfroTada new website code\nigerProverbs.html", "HTML", 75, 0, 0, 0, 0, 8, 2, 85
"c:\Users\OlabayoBalogun\Documents\GitHub\AfroTada new website code\nigerQuotes.html", "HTML", 75, 0, 0, 0, 0, 8, 2, 85
"c:\Users\OlabayoBalogun\Documents\GitHub\AfroTada new website code\nigerUniversities.html", "HTML", 75, 0, 0, 0, 0, 8, 2, 85
"c:\Users\OlabayoBalogun\Documents\GitHub\AfroTada new website code\nigerWriters.html", "HTML", 75, 0, 0, 0, 0, 8, 2, 85
"c:\Users\OlabayoBalogun\Documents\GitHub\AfroTada new website code\nigeria.html", "HTML", 157, 0, 0, 0, 0, 8, 3, 168
"c:\Users\OlabayoBalogun\Documents\GitHub\AfroTada new website code\nigerianBooks.html", "HTML", 161, 0, 0, 0, 0, 8, 1, 170
"c:\Users\OlabayoBalogun\Documents\GitHub\AfroTada new website code\nigerianCulture.html", "HTML", 75, 0, 0, 0, 0, 8, 2, 85
"c:\Users\OlabayoBalogun\Documents\GitHub\AfroTada new website code\nigerianDocumentaries.html", "HTML", 75, 0, 0, 0, 0, 8, 2, 85
"c:\Users\OlabayoBalogun\Documents\GitHub\AfroTada new website code\nigerianFood.html", "HTML", 75, 0, 0, 0, 0, 8, 2, 85
"c:\Users\OlabayoBalogun\Documents\GitHub\AfroTada new website code\nigerianHistoricalSites.html", "HTML", 75, 0, 0, 0, 0, 8, 2, 85
"c:\Users\OlabayoBalogun\Documents\GitHub\AfroTada new website code\nigerianNaturalResources.html", "HTML", 75, 0, 0, 0, 0, 8, 2, 85
"c:\Users\OlabayoBalogun\Documents\GitHub\AfroTada new website code\nigerianPodcasts.html", "HTML", 75, 0, 0, 0, 0, 8, 2, 85
"c:\Users\OlabayoBalogun\Documents\GitHub\AfroTada new website code\nigerianPoets.html", "HTML", 75, 0, 0, 0, 0, 8, 2, 85
"c:\Users\OlabayoBalogun\Documents\GitHub\AfroTada new website code\nigerianProverbs.html", "HTML", 75, 0, 0, 0, 0, 8, 2, 85
"c:\Users\OlabayoBalogun\Documents\GitHub\AfroTada new website code\nigerianQuotes.html", "HTML", 75, 0, 0, 0, 0, 8, 2, 85
"c:\Users\OlabayoBalogun\Documents\GitHub\AfroTada new website code\nigerianUniversities.html", "HTML", 75, 0, 0, 0, 0, 8, 2, 85
"c:\Users\OlabayoBalogun\Documents\GitHub\AfroTada new website code\nigerianWriters.html", "HTML", 75, 0, 0, 0, 0, 8, 2, 85
"c:\Users\OlabayoBalogun\Documents\GitHub\AfroTada new website code\privacyPolicy.html", "HTML", 220, 0, 0, 0, 0, 8, 26, 254
"c:\Users\OlabayoBalogun\Documents\GitHub\AfroTada new website code\republicOfCongo.html", "HTML", 157, 0, 0, 0, 0, 8, 3, 168
"c:\Users\OlabayoBalogun\Documents\GitHub\AfroTada new website code\republicOfCongoBooks.html", "HTML", 75, 0, 0, 0, 0, 8, 2, 85
"c:\Users\OlabayoBalogun\Documents\GitHub\AfroTada new website code\republicOfCongoCulture.html", "HTML", 75, 0, 0, 0, 0, 8, 2, 85
"c:\Users\OlabayoBalogun\Documents\GitHub\AfroTada new website code\republicOfCongoDocumentaries.html", "HTML", 75, 0, 0, 0, 0, 8, 2, 85
"c:\Users\OlabayoBalogun\Documents\GitHub\AfroTada new website code\republicOfCongoFood.html", "HTML", 75, 0, 0, 0, 0, 8, 2, 85
"c:\Users\OlabayoBalogun\Documents\GitHub\AfroTada new website code\republicOfCongoHistoricalSites.html", "HTML", 75, 0, 0, 0, 0, 8, 2, 85
"c:\Users\OlabayoBalogun\Documents\GitHub\AfroTada new website code\republicOfCongoNaturalResources.html", "HTML", 75, 0, 0, 0, 0, 8, 2, 85
"c:\Users\OlabayoBalogun\Documents\GitHub\AfroTada new website code\republicOfCongoPodcasts.html", "HTML", 75, 0, 0, 0, 0, 8, 2, 85
"c:\Users\OlabayoBalogun\Documents\GitHub\AfroTada new website code\republicOfCongoPoets.html", "HTML", 76, 0, 0, 0, 0, 8, 2, 86
"c:\Users\OlabayoBalogun\Documents\GitHub\AfroTada new website code\republicOfCongoProverbs.html", "HTML", 75, 0, 0, 0, 0, 8, 2, 85
"c:\Users\OlabayoBalogun\Documents\GitHub\AfroTada new website code\republicOfCongoQuotes.html", "HTML", 75, 0, 0, 0, 0, 8, 2, 85
"c:\Users\OlabayoBalogun\Documents\GitHub\AfroTada new website code\republicOfCongoUniversities.html", "HTML", 75, 0, 0, 0, 0, 8, 2, 85
"c:\Users\OlabayoBalogun\Documents\GitHub\AfroTada new website code\republicOfCongoWriters.html", "HTML", 75, 0, 0, 0, 0, 8, 2, 85
"c:\Users\OlabayoBalogun\Documents\GitHub\AfroTada new website code\resources.html", "HTML", 165, 0, 0, 0, 0, 8, 3, 176
"c:\Users\OlabayoBalogun\Documents\GitHub\AfroTada new website code\resourcesByCountry.html", "HTML", 514, 0, 0, 0, 0, 8, 56, 578
"c:\Users\OlabayoBalogun\Documents\GitHub\AfroTada new website code\rwanda.html", "HTML", 157, 0, 0, 0, 0, 8, 3, 168
"c:\Users\OlabayoBalogun\Documents\GitHub\AfroTada new website code\rwandaBooks.html", "HTML", 75, 0, 0, 0, 0, 8, 2, 85
"c:\Users\OlabayoBalogun\Documents\GitHub\AfroTada new website code\rwandaCulture.html", "HTML", 75, 0, 0, 0, 0, 8, 2, 85
"c:\Users\OlabayoBalogun\Documents\GitHub\AfroTada new website code\rwandaDocumentaries.html", "HTML", 75, 0, 0, 0, 0, 8, 2, 85
"c:\Users\OlabayoBalogun\Documents\GitHub\AfroTada new website code\rwandaFood.html", "HTML", 75, 0, 0, 0, 0, 8, 2, 85
"c:\Users\OlabayoBalogun\Documents\GitHub\AfroTada new website code\rwandaHistoricalSites.html", "HTML", 75, 0, 0, 0, 0, 8, 2, 85
"c:\Users\OlabayoBalogun\Documents\GitHub\AfroTada new website code\rwandaNaturalResources.html", "HTML", 75, 0, 0, 0, 0, 8, 2, 85
"c:\Users\OlabayoBalogun\Documents\GitHub\AfroTada new website code\rwandaPodcasts.html", "HTML", 75, 0, 0, 0, 0, 8, 2, 85
"c:\Users\OlabayoBalogun\Documents\GitHub\AfroTada new website code\rwandaPoets.html", "HTML", 75, 0, 0, 0, 0, 8, 2, 85
"c:\Users\OlabayoBalogun\Documents\GitHub\AfroTada new website code\rwandaProverbs.html", "HTML", 76, 0, 0, 0, 0, 8, 2, 86
"c:\Users\OlabayoBalogun\Documents\GitHub\AfroTada new website code\rwandaQuotes.html", "HTML", 75, 0, 0, 0, 0, 8, 2, 85
"c:\Users\OlabayoBalogun\Documents\GitHub\AfroTada new website code\rwandaUniversities.html", "HTML", 75, 0, 0, 0, 0, 8, 2, 85
"c:\Users\OlabayoBalogun\Documents\GitHub\AfroTada new website code\rwandaWriters.html", "HTML", 75, 0, 0, 0, 0, 8, 2, 85
"c:\Users\OlabayoBalogun\Documents\GitHub\AfroTada new website code\saoTomeAndPrincipe.html", "HTML", 157, 0, 0, 0, 0, 8, 3, 168
"c:\Users\OlabayoBalogun\Documents\GitHub\AfroTada new website code\saoTomeAndPrincipeBooks.html", "HTML", 75, 0, 0, 0, 0, 8, 2, 85
"c:\Users\OlabayoBalogun\Documents\GitHub\AfroTada new website code\saoTomeAndPrincipeCulture.html", "HTML", 75, 0, 0, 0, 0, 8, 2, 85
"c:\Users\OlabayoBalogun\Documents\GitHub\AfroTada new website code\saoTomeAndPrincipeDocumentaries.html", "HTML", 75, 0, 0, 0, 0, 8, 2, 85
"c:\Users\OlabayoBalogun\Documents\GitHub\AfroTada new website code\saoTomeAndPrincipeFood.html", "HTML", 75, 0, 0, 0, 0, 8, 2, 85
"c:\Users\OlabayoBalogun\Documents\GitHub\AfroTada new website code\saoTomeAndPrincipeHistoricalSites.html", "HTML", 75, 0, 0, 0, 0, 8, 2, 85
"c:\Users\OlabayoBalogun\Documents\GitHub\AfroTada new website code\saoTomeAndPrincipeNaturalResources.html", "HTML", 75, 0, 0, 0, 0, 8, 2, 85
"c:\Users\OlabayoBalogun\Documents\GitHub\AfroTada new website code\saoTomeAndPrincipePodcasts.html", "HTML", 75, 0, 0, 0, 0, 8, 2, 85
"c:\Users\OlabayoBalogun\Documents\GitHub\AfroTada new website code\saoTomeAndPrincipePoets.html", "HTML", 75, 0, 0, 0, 0, 8, 2, 85
"c:\Users\OlabayoBalogun\Documents\GitHub\AfroTada new website code\saoTomeAndPrincipeProverbs.html", "HTML", 75, 0, 0, 0, 0, 8, 2, 85
"c:\Users\OlabayoBalogun\Documents\GitHub\AfroTada new website code\saoTomeAndPrincipeQuotes.html", "HTML", 75, 0, 0, 0, 0, 8, 2, 85
"c:\Users\OlabayoBalogun\Documents\GitHub\AfroTada new website code\saoTomeAndPrincipeUniversities.html", "HTML", 75, 0, 0, 0, 0, 8, 2, 85
"c:\Users\OlabayoBalogun\Documents\GitHub\AfroTada new website code\saoTomeAndPrincipeWriters.html", "HTML", 75, 0, 0, 0, 0, 8, 2, 85
"c:\Users\OlabayoBalogun\Documents\GitHub\AfroTada new website code\senegal.html", "HTML", 157, 0, 0, 0, 0, 8, 3, 168
"c:\Users\OlabayoBalogun\Documents\GitHub\AfroTada new website code\senegalBooks.html", "HTML", 75, 0, 0, 0, 0, 8, 2, 85
"c:\Users\OlabayoBalogun\Documents\GitHub\AfroTada new website code\senegalCulture.html", "HTML", 75, 0, 0, 0, 0, 8, 2, 85
"c:\Users\OlabayoBalogun\Documents\GitHub\AfroTada new website code\senegalDocumentaries.html", "HTML", 75, 0, 0, 0, 0, 8, 2, 85
"c:\Users\OlabayoBalogun\Documents\GitHub\AfroTada new website code\senegalFood.html", "HTML", 75, 0, 0, 0, 0, 8, 2, 85
"c:\Users\OlabayoBalogun\Documents\GitHub\AfroTada new website code\senegalHistoricalSites.html", "HTML", 75, 0, 0, 0, 0, 8, 2, 85
"c:\Users\OlabayoBalogun\Documents\GitHub\AfroTada new website code\senegalNaturalResources.html", "HTML", 75, 0, 0, 0, 0, 8, 2, 85
"c:\Users\OlabayoBalogun\Documents\GitHub\AfroTada new website code\senegalPodcasts.html", "HTML", 75, 0, 0, 0, 0, 8, 2, 85
"c:\Users\OlabayoBalogun\Documents\GitHub\AfroTada new website code\senegalPoets.html", "HTML", 75, 0, 0, 0, 0, 8, 2, 85
"c:\Users\OlabayoBalogun\Documents\GitHub\AfroTada new website code\senegalProverbs.html", "HTML", 75, 0, 0, 0, 0, 8, 2, 85
"c:\Users\OlabayoBalogun\Documents\GitHub\AfroTada new website code\senegalQuotes.html", "HTML", 75, 0, 0, 0, 0, 8, 2, 85
"c:\Users\OlabayoBalogun\Documents\GitHub\AfroTada new website code\senegalUniversities.html", "HTML", 75, 0, 0, 0, 0, 8, 2, 85
"c:\Users\OlabayoBalogun\Documents\GitHub\AfroTada new website code\senegalWriters.html", "HTML", 75, 0, 0, 0, 0, 8, 2, 85
"c:\Users\OlabayoBalogun\Documents\GitHub\AfroTada new website code\seychelles.html", "HTML", 157, 0, 0, 0, 0, 8, 3, 168
"c:\Users\OlabayoBalogun\Documents\GitHub\AfroTada new website code\seychellesBooks.html", "HTML", 75, 0, 0, 0, 0, 8, 2, 85
"c:\Users\OlabayoBalogun\Documents\GitHub\AfroTada new website code\seychellesCulture.html", "HTML", 75, 0, 0, 0, 0, 8, 2, 85
"c:\Users\OlabayoBalogun\Documents\GitHub\AfroTada new website code\seychellesDocumentaries.html", "HTML", 75, 0, 0, 0, 0, 8, 2, 85
"c:\Users\OlabayoBalogun\Documents\GitHub\AfroTada new website code\seychellesFood.html", "HTML", 75, 0, 0, 0, 0, 8, 2, 85
"c:\Users\OlabayoBalogun\Documents\GitHub\AfroTada new website code\seychellesHistoricalSites.html", "HTML", 75, 0, 0, 0, 0, 8, 2, 85
"c:\Users\OlabayoBalogun\Documents\GitHub\AfroTada new website code\seychellesNaturalResources.html", "HTML", 75, 0, 0, 0, 0, 8, 2, 85
"c:\Users\OlabayoBalogun\Documents\GitHub\AfroTada new website code\seychellesPodcasts.html", "HTML", 75, 0, 0, 0, 0, 8, 2, 85
"c:\Users\OlabayoBalogun\Documents\GitHub\AfroTada new website code\seychellesPoets.html", "HTML", 75, 0, 0, 0, 0, 8, 2, 85
"c:\Users\OlabayoBalogun\Documents\GitHub\AfroTada new website code\seychellesProverbs.html", "HTML", 150, 0, 0, 0, 0, 16, 4, 170
"c:\Users\OlabayoBalogun\Documents\GitHub\AfroTada new website code\seychellesQuotes.html", "HTML", 150, 0, 0, 0, 0, 16, 4, 170
"c:\Users\OlabayoBalogun\Documents\GitHub\AfroTada new website code\seychellesUniversities.html", "HTML", 75, 0, 0, 0, 0, 8, 2, 85
"c:\Users\OlabayoBalogun\Documents\GitHub\AfroTada new website code\sierraLeone.html", "HTML", 157, 0, 0, 0, 0, 8, 3, 168
"c:\Users\OlabayoBalogun\Documents\GitHub\AfroTada new website code\sierraLeoneBooks.html", "HTML", 75, 0, 0, 0, 0, 8, 2, 85
"c:\Users\OlabayoBalogun\Documents\GitHub\AfroTada new website code\sierraLeoneCulture.html", "HTML", 75, 0, 0, 0, 0, 8, 2, 85
"c:\Users\OlabayoBalogun\Documents\GitHub\AfroTada new website code\sierraLeoneDocumentaries.html", "HTML", 75, 0, 0, 0, 0, 8, 2, 85
"c:\Users\OlabayoBalogun\Documents\GitHub\AfroTada new website code\sierraLeoneFood.html", "HTML", 75, 0, 0, 0, 0, 8, 2, 85
"c:\Users\OlabayoBalogun\Documents\GitHub\AfroTada new website code\sierraLeoneHistoricalSites.html", "HTML", 75, 0, 0, 0, 0, 8, 2, 85
"c:\Users\OlabayoBalogun\Documents\GitHub\AfroTada new website code\sierraLeoneNaturalResources.html", "HTML", 75, 0, 0, 0, 0, 8, 2, 85
"c:\Users\OlabayoBalogun\Documents\GitHub\AfroTada new website code\sierraLeonePodcasts.html", "HTML", 75, 0, 0, 0, 0, 8, 2, 85
"c:\Users\OlabayoBalogun\Documents\GitHub\AfroTada new website code\sierraLeonePoets.html", "HTML", 75, 0, 0, 0, 0, 8, 2, 85
"c:\Users\OlabayoBalogun\Documents\GitHub\AfroTada new website code\sierraLeoneProverbs.html", "HTML", 75, 0, 0, 0, 0, 8, 2, 85
"c:\Users\OlabayoBalogun\Documents\GitHub\AfroTada new website code\sierraLeoneQuotes.html", "HTML", 150, 0, 0, 0, 0, 16, 4, 170
"c:\Users\OlabayoBalogun\Documents\GitHub\AfroTada new website code\sierraLeoneUniversities.html", "HTML", 75, 0, 0, 0, 0, 8, 2, 85
"c:\Users\OlabayoBalogun\Documents\GitHub\AfroTada new website code\sierraLeoneWriters.html", "HTML", 75, 0, 0, 0, 0, 8, 2, 85
"c:\Users\OlabayoBalogun\Documents\GitHub\AfroTada new website code\somalia.html", "HTML", 157, 0, 0, 0, 0, 8, 3, 168
"c:\Users\OlabayoBalogun\Documents\GitHub\AfroTada new website code\somaliaBooks.html", "HTML", 76, 0, 0, 0, 0, 8, 2, 86
"c:\Users\OlabayoBalogun\Documents\GitHub\AfroTada new website code\somaliaCulture.html", "HTML", 75, 0, 0, 0, 0, 8, 2, 85
"c:\Users\OlabayoBalogun\Documents\GitHub\AfroTada new website code\somaliaDocumentaries.html", "HTML", 75, 0, 0, 0, 0, 8, 2, 85
"c:\Users\OlabayoBalogun\Documents\GitHub\AfroTada new website code\somaliaFood.html", "HTML", 75, 0, 0, 0, 0, 8, 2, 85
"c:\Users\OlabayoBalogun\Documents\GitHub\AfroTada new website code\somaliaHistoricalSites.html", "HTML", 75, 0, 0, 0, 0, 8, 2, 85
"c:\Users\OlabayoBalogun\Documents\GitHub\AfroTada new website code\somaliaNaturalResources.html", "HTML", 75, 0, 0, 0, 0, 8, 2, 85
"c:\Users\OlabayoBalogun\Documents\GitHub\AfroTada new website code\somaliaPodcasts.html", "HTML", 75, 0, 0, 0, 0, 8, 2, 85
"c:\Users\OlabayoBalogun\Documents\GitHub\AfroTada new website code\somaliaPoets.html", "HTML", 75, 0, 0, 0, 0, 8, 2, 85
"c:\Users\OlabayoBalogun\Documents\GitHub\AfroTada new website code\somaliaProverbs.html", "HTML", 75, 0, 0, 0, 0, 8, 2, 85
"c:\Users\OlabayoBalogun\Documents\GitHub\AfroTada new website code\somaliaQuotes.html", "HTML", 75, 0, 0, 0, 0, 8, 2, 85
"c:\Users\OlabayoBalogun\Documents\GitHub\AfroTada new website code\somaliaUniversities.html", "HTML", 75, 0, 0, 0, 0, 8, 2, 85
"c:\Users\OlabayoBalogun\Documents\GitHub\AfroTada new website code\somaliaWriters.html", "HTML", 75, 0, 0, 0, 0, 8, 2, 85
"c:\Users\OlabayoBalogun\Documents\GitHub\AfroTada new website code\southAfrica.html", "HTML", 157, 0, 0, 0, 0, 8, 3, 168
"c:\Users\OlabayoBalogun\Documents\GitHub\AfroTada new website code\southAfricanBooks.html", "HTML", 75, 0, 0, 0, 0, 8, 2, 85
"c:\Users\OlabayoBalogun\Documents\GitHub\AfroTada new website code\southAfricanCulture.html", "HTML", 75, 0, 0, 0, 0, 8, 2, 85
"c:\Users\OlabayoBalogun\Documents\GitHub\AfroTada new website code\southAfricanDocumentaries.html", "HTML", 75, 0, 0, 0, 0, 8, 2, 85
"c:\Users\OlabayoBalogun\Documents\GitHub\AfroTada new website code\southAfricanFood.html", "HTML", 75, 0, 0, 0, 0, 8, 2, 85
"c:\Users\OlabayoBalogun\Documents\GitHub\AfroTada new website code\southAfricanHistoricalSites.html", "HTML", 75, 0, 0, 0, 0, 8, 2, 85
"c:\Users\OlabayoBalogun\Documents\GitHub\AfroTada new website code\southAfricanNaturalResources.html", "HTML", 75, 0, 0, 0, 0, 8, 2, 85
"c:\Users\OlabayoBalogun\Documents\GitHub\AfroTada new website code\southAfricanPodcasts.html", "HTML", 75, 0, 0, 0, 0, 8, 2, 85
"c:\Users\OlabayoBalogun\Documents\GitHub\AfroTada new website code\southAfricanPoets.html", "HTML", 75, 0, 0, 0, 0, 8, 2, 85
"c:\Users\OlabayoBalogun\Documents\GitHub\AfroTada new website code\southAfricanProverbs.html", "HTML", 75, 0, 0, 0, 0, 8, 2, 85
"c:\Users\OlabayoBalogun\Documents\GitHub\AfroTada new website code\southAfricanQuotes.html", "HTML", 75, 0, 0, 0, 0, 8, 2, 85
"c:\Users\OlabayoBalogun\Documents\GitHub\AfroTada new website code\southAfricanUniversities.html", "HTML", 75, 0, 0, 0, 0, 8, 2, 85
"c:\Users\OlabayoBalogun\Documents\GitHub\AfroTada new website code\southAfricanWriters.html", "HTML", 76, 0, 0, 0, 0, 8, 2, 86
"c:\Users\OlabayoBalogun\Documents\GitHub\AfroTada new website code\southSudan.html", "HTML", 157, 0, 0, 0, 0, 8, 3, 168
"c:\Users\OlabayoBalogun\Documents\GitHub\AfroTada new website code\southSudanBooks.html", "HTML", 75, 0, 0, 0, 0, 8, 2, 85
"c:\Users\OlabayoBalogun\Documents\GitHub\AfroTada new website code\southSudanCulture.html", "HTML", 75, 0, 0, 0, 0, 8, 2, 85
"c:\Users\OlabayoBalogun\Documents\GitHub\AfroTada new website code\southSudanDocumentaries.html", "HTML", 75, 0, 0, 0, 0, 8, 2, 85
"c:\Users\OlabayoBalogun\Documents\GitHub\AfroTada new website code\southSudanFood.html", "HTML", 75, 0, 0, 0, 0, 8, 2, 85
"c:\Users\OlabayoBalogun\Documents\GitHub\AfroTada new website code\southSudanHistoricalSites.html", "HTML", 75, 0, 0, 0, 0, 8, 2, 85
"c:\Users\OlabayoBalogun\Documents\GitHub\AfroTada new website code\southSudanNaturalResources.html", "HTML", 75, 0, 0, 0, 0, 8, 2, 85
"c:\Users\OlabayoBalogun\Documents\GitHub\AfroTada new website code\southSudanPodcasts.html", "HTML", 75, 0, 0, 0, 0, 8, 2, 85
"c:\Users\OlabayoBalogun\Documents\GitHub\AfroTada new website code\southSudanPoets.html", "HTML", 75, 0, 0, 0, 0, 8, 2, 85
"c:\Users\OlabayoBalogun\Documents\GitHub\AfroTada new website code\southSudanProverbs.html", "HTML", 75, 0, 0, 0, 0, 8, 2, 85
"c:\Users\OlabayoBalogun\Documents\GitHub\AfroTada new website code\southSudanQuotes.html", "HTML", 75, 0, 0, 0, 0, 8, 2, 85
"c:\Users\OlabayoBalogun\Documents\GitHub\AfroTada new website code\southSudanUniversities.html", "HTML", 75, 0, 0, 0, 0, 8, 2, 85
"c:\Users\OlabayoBalogun\Documents\GitHub\AfroTada new website code\southSudanWriters.html", "HTML", 75, 0, 0, 0, 0, 8, 2, 85
"c:\Users\OlabayoBalogun\Documents\GitHub\AfroTada new website code\sudan.html", "HTML", 157, 0, 0, 0, 0, 8, 3, 168
"c:\Users\OlabayoBalogun\Documents\GitHub\AfroTada new website code\sudanBooks.html", "HTML", 75, 0, 0, 0, 0, 8, 2, 85
"c:\Users\OlabayoBalogun\Documents\GitHub\AfroTada new website code\sudanCulture.html", "HTML", 75, 0, 0, 0, 0, 8, 2, 85
"c:\Users\OlabayoBalogun\Documents\GitHub\AfroTada new website code\sudanDocumentaries.html", "HTML", 75, 0, 0, 0, 0, 8, 2, 85
"c:\Users\OlabayoBalogun\Documents\GitHub\AfroTada new website code\sudanFood.html", "HTML", 75, 0, 0, 0, 0, 8, 2, 85
"c:\Users\OlabayoBalogun\Documents\GitHub\AfroTada new website code\sudanHistoricalSites.html", "HTML", 75, 0, 0, 0, 0, 8, 2, 85
"c:\Users\OlabayoBalogun\Documents\GitHub\AfroTada new website code\sudanNaturalResources.html", "HTML", 75, 0, 0, 0, 0, 8, 2, 85
"c:\Users\OlabayoBalogun\Documents\GitHub\AfroTada new website code\sudanPodcasts.html", "HTML", 75, 0, 0, 0, 0, 8, 2, 85
"c:\Users\OlabayoBalogun\Documents\GitHub\AfroTada new website code\sudanPoets.html", "HTML", 75, 0, 0, 0, 0, 8, 2, 85
"c:\Users\OlabayoBalogun\Documents\GitHub\AfroTada new website code\sudanProverbs.html", "HTML", 75, 0, 0, 0, 0, 8, 2, 85
"c:\Users\OlabayoBalogun\Documents\GitHub\AfroTada new website code\sudanQuotes.html", "HTML", 75, 0, 0, 0, 0, 8, 2, 85
"c:\Users\OlabayoBalogun\Documents\GitHub\AfroTada new website code\sudanUniversities.html", "HTML", 75, 0, 0, 0, 0, 8, 2, 85
"c:\Users\OlabayoBalogun\Documents\GitHub\AfroTada new website code\sudanWriters.html", "HTML", 75, 0, 0, 0, 0, 8, 2, 85
"c:\Users\OlabayoBalogun\Documents\GitHub\AfroTada new website code\tanzania.html", "HTML", 157, 0, 0, 0, 0, 8, 3, 168
"c:\Users\OlabayoBalogun\Documents\GitHub\AfroTada new website code\tanzaniaBooks.html", "HTML", 75, 0, 0, 0, 0, 8, 2, 85
"c:\Users\OlabayoBalogun\Documents\GitHub\AfroTada new website code\tanzaniaCulture.html", "HTML", 75, 0, 0, 0, 0, 8, 2, 85
"c:\Users\OlabayoBalogun\Documents\GitHub\AfroTada new website code\tanzaniaDocumentaries.html", "HTML", 75, 0, 0, 0, 0, 8, 2, 85
"c:\Users\OlabayoBalogun\Documents\GitHub\AfroTada new website code\tanzaniaFood.html", "HTML", 75, 0, 0, 0, 0, 8, 2, 85
"c:\Users\OlabayoBalogun\Documents\GitHub\AfroTada new website code\tanzaniaHistoricalSites.html", "HTML", 75, 0, 0, 0, 0, 8, 2, 85
"c:\Users\OlabayoBalogun\Documents\GitHub\AfroTada new website code\tanzaniaNaturalResources.html", "HTML", 75, 0, 0, 0, 0, 8, 2, 85
"c:\Users\OlabayoBalogun\Documents\GitHub\AfroTada new website code\tanzaniaPodcasts.html", "HTML", 75, 0, 0, 0, 0, 8, 2, 85
"c:\Users\OlabayoBalogun\Documents\GitHub\AfroTada new website code\tanzaniaPoets.html", "HTML", 75, 0, 0, 0, 0, 8, 2, 85
"c:\Users\OlabayoBalogun\Documents\GitHub\AfroTada new website code\tanzaniaProverbs.html", "HTML", 75, 0, 0, 0, 0, 8, 2, 85
"c:\Users\OlabayoBalogun\Documents\GitHub\AfroTada new website code\tanzaniaQuotes.html", "HTML", 75, 0, 0, 0, 0, 8, 2, 85
"c:\Users\OlabayoBalogun\Documents\GitHub\AfroTada new website code\tanzaniaUniversities.html", "HTML", 75, 0, 0, 0, 0, 8, 2, 85
"c:\Users\OlabayoBalogun\Documents\GitHub\AfroTada new website code\tanzaniaWriters.html", "HTML", 75, 0, 0, 0, 0, 8, 2, 85
"c:\Users\OlabayoBalogun\Documents\GitHub\AfroTada new website code\termsOfUse.html", "HTML", 146, 0, 0, 0, 0, 6, 20, 172
"c:\Users\OlabayoBalogun\Documents\GitHub\AfroTada new website code\togo.html", "HTML", 157, 0, 0, 0, 0, 8, 3, 168
"c:\Users\OlabayoBalogun\Documents\GitHub\AfroTada new website code\togoBooks.html", "HTML", 75, 0, 0, 0, 0, 8, 2, 85
"c:\Users\OlabayoBalogun\Documents\GitHub\AfroTada new website code\togoCulture.html", "HTML", 75, 0, 0, 0, 0, 8, 2, 85
"c:\Users\OlabayoBalogun\Documents\GitHub\AfroTada new website code\togoDocumentaries.html", "HTML", 75, 0, 0, 0, 0, 8, 2, 85
"c:\Users\OlabayoBalogun\Documents\GitHub\AfroTada new website code\togoFood.html", "HTML", 75, 0, 0, 0, 0, 8, 2, 85
"c:\Users\OlabayoBalogun\Documents\GitHub\AfroTada new website code\togoHistoricalSites.html", "HTML", 75, 0, 0, 0, 0, 8, 2, 85
"c:\Users\OlabayoBalogun\Documents\GitHub\AfroTada new website code\togoNaturalResources.html", "HTML", 75, 0, 0, 0, 0, 8, 2, 85
"c:\Users\OlabayoBalogun\Documents\GitHub\AfroTada new website code\togoPodcasts.html", "HTML", 75, 0, 0, 0, 0, 8, 2, 85
"c:\Users\OlabayoBalogun\Documents\GitHub\AfroTada new website code\togoPoets.html", "HTML", 75, 0, 0, 0, 0, 8, 2, 85
"c:\Users\OlabayoBalogun\Documents\GitHub\AfroTada new website code\togoProverbs.html", "HTML", 75, 0, 0, 0, 0, 8, 2, 85
"c:\Users\OlabayoBalogun\Documents\GitHub\AfroTada new website code\togoQuotes.html", "HTML", 75, 0, 0, 0, 0, 8, 2, 85
"c:\Users\OlabayoBalogun\Documents\GitHub\AfroTada new website code\togoUniversities.html", "HTML", 75, 0, 0, 0, 0, 8, 2, 85
"c:\Users\OlabayoBalogun\Documents\GitHub\AfroTada new website code\togoWriters.html", "HTML", 75, 0, 0, 0, 0, 8, 2, 85
"c:\Users\OlabayoBalogun\Documents\GitHub\AfroTada new website code\tunisia.html", "HTML", 157, 0, 0, 0, 0, 8, 3, 168
"c:\Users\OlabayoBalogun\Documents\GitHub\AfroTada new website code\tunisiaBooks.html", "HTML", 75, 0, 0, 0, 0, 8, 2, 85
"c:\Users\OlabayoBalogun\Documents\GitHub\AfroTada new website code\tunisiaCulture.html", "HTML", 75, 0, 0, 0, 0, 8, 2, 85
"c:\Users\OlabayoBalogun\Documents\GitHub\AfroTada new website code\tunisiaDocumentaries.html", "HTML", 75, 0, 0, 0, 0, 8, 2, 85
"c:\Users\OlabayoBalogun\Documents\GitHub\AfroTada new website code\tunisiaFood.html", "HTML", 75, 0, 0, 0, 0, 8, 2, 85
"c:\Users\OlabayoBalogun\Documents\GitHub\AfroTada new website code\tunisiaHistoricalSites.html", "HTML", 75, 0, 0, 0, 0, 8, 2, 85
"c:\Users\OlabayoBalogun\Documents\GitHub\AfroTada new website code\tunisiaNaturalResources.html", "HTML", 75, 0, 0, 0, 0, 8, 2, 85
"c:\Users\OlabayoBalogun\Documents\GitHub\AfroTada new website code\tunisiaPodcasts.html", "HTML", 75, 0, 0, 0, 0, 8, 2, 85
"c:\Users\OlabayoBalogun\Documents\GitHub\AfroTada new website code\tunisiaPoets.html", "HTML", 75, 0, 0, 0, 0, 8, 2, 85
"c:\Users\OlabayoBalogun\Documents\GitHub\AfroTada new website code\tunisiaProverbs.html", "HTML", 75, 0, 0, 0, 0, 8, 2, 85
"c:\Users\OlabayoBalogun\Documents\GitHub\AfroTada new website code\tunisiaQuotes.html", "HTML", 75, 0, 0, 0, 0, 8, 2, 85
"c:\Users\OlabayoBalogun\Documents\GitHub\AfroTada new website code\tunisiaUniversities.html", "HTML", 75, 0, 0, 0, 0, 8, 2, 85
"c:\Users\OlabayoBalogun\Documents\GitHub\AfroTada new website code\tunisiaWriters.html", "HTML", 75, 0, 0, 0, 0, 8, 2, 85
"c:\Users\OlabayoBalogun\Documents\GitHub\AfroTada new website code\uganda.html", "HTML", 157, 0, 0, 0, 0, 8, 3, 168
"c:\Users\OlabayoBalogun\Documents\GitHub\AfroTada new website code\ugandaBooks.html", "HTML", 75, 0, 0, 0, 0, 8, 2, 85
"c:\Users\OlabayoBalogun\Documents\GitHub\AfroTada new website code\ugandaCulture.html", "HTML", 75, 0, 0, 0, 0, 8, 2, 85
"c:\Users\OlabayoBalogun\Documents\GitHub\AfroTada new website code\ugandaDocumentaries.html", "HTML", 75, 0, 0, 0, 0, 8, 2, 85
"c:\Users\OlabayoBalogun\Documents\GitHub\AfroTada new website code\ugandaFood.html", "HTML", 75, 0, 0, 0, 0, 8, 2, 85
"c:\Users\OlabayoBalogun\Documents\GitHub\AfroTada new website code\ugandaHistoricalSites.html", "HTML", 75, 0, 0, 0, 0, 8, 2, 85
"c:\Users\OlabayoBalogun\Documents\GitHub\AfroTada new website code\ugandaNaturalResources.html", "HTML", 75, 0, 0, 0, 0, 8, 2, 85
"c:\Users\OlabayoBalogun\Documents\GitHub\AfroTada new website code\ugandaPodcasts.html", "HTML", 75, 0, 0, 0, 0, 8, 2, 85
"c:\Users\OlabayoBalogun\Documents\GitHub\AfroTada new website code\ugandaPoets.html", "HTML", 75, 0, 0, 0, 0, 8, 2, 85
"c:\Users\OlabayoBalogun\Documents\GitHub\AfroTada new website code\ugandaProverbs.html", "HTML", 75, 0, 0, 0, 0, 8, 2, 85
"c:\Users\OlabayoBalogun\Documents\GitHub\AfroTada new website code\ugandaQuotes.html", "HTML", 75, 0, 0, 0, 0, 8, 2, 85
"c:\Users\OlabayoBalogun\Documents\GitHub\AfroTada new website code\ugandaUniversities.html", "HTML", 75, 0, 0, 0, 0, 8, 2, 85
"c:\Users\OlabayoBalogun\Documents\GitHub\AfroTada new website code\ugandaWriters.html", "HTML", 75, 0, 0, 0, 0, 8, 2, 85
"c:\Users\OlabayoBalogun\Documents\GitHub\AfroTada new website code\volunteer.html", "HTML", 99, 0, 0, 0, 0, 8, 3, 110
"c:\Users\OlabayoBalogun\Documents\GitHub\AfroTada new website code\zambia.html", "HTML", 157, 0, 0, 0, 0, 8, 3, 168
"c:\Users\OlabayoBalogun\Documents\GitHub\AfroTada new website code\zambiaBooks.html", "HTML", 75, 0, 0, 0, 0, 8, 2, 85
"c:\Users\OlabayoBalogun\Documents\GitHub\AfroTada new website code\zambiaCulture.html", "HTML", 75, 0, 0, 0, 0, 8, 2, 85
"c:\Users\OlabayoBalogun\Documents\GitHub\AfroTada new website code\zambiaDocumentaries.html", "HTML", 75, 0, 0, 0, 0, 8, 2, 85
"c:\Users\OlabayoBalogun\Documents\GitHub\AfroTada new website code\zambiaFood.html", "HTML", 75, 0, 0, 0, 0, 8, 2, 85
"c:\Users\OlabayoBalogun\Documents\GitHub\AfroTada new website code\zambiaHistoricalSites.html", "HTML", 75, 0, 0, 0, 0, 8, 2, 85
"c:\Users\OlabayoBalogun\Documents\GitHub\AfroTada new website code\zambiaNaturalResources.html", "HTML", 75, 0, 0, 0, 0, 8, 2, 85
"c:\Users\OlabayoBalogun\Documents\GitHub\AfroTada new website code\zambiaPodcasts.html", "HTML", 75, 0, 0, 0, 0, 8, 2, 85
"c:\Users\OlabayoBalogun\Documents\GitHub\AfroTada new website code\zambiaPoets.html", "HTML", 75, 0, 0, 0, 0, 8, 2, 85
"c:\Users\OlabayoBalogun\Documents\GitHub\AfroTada new website code\zambiaProverbs.html", "HTML", 75, 0, 0, 0, 0, 8, 2, 85
"c:\Users\OlabayoBalogun\Documents\GitHub\AfroTada new website code\zambiaQuotes.html", "HTML", 75, 0, 0, 0, 0, 8, 3, 86
"c:\Users\OlabayoBalogun\Documents\GitHub\AfroTada new website code\zambiaUniversities.html", "HTML", 75, 0, 0, 0, 0, 8, 2, 85
"c:\Users\OlabayoBalogun\Documents\GitHub\AfroTada new website code\zambiaWriters.html", "HTML", 75, 0, 0, 0, 0, 8, 2, 85
"c:\Users\OlabayoBalogun\Documents\GitHub\AfroTada new website code\zimbabwe.html", "HTML", 157, 0, 0, 0, 0, 8, 3, 168
"c:\Users\OlabayoBalogun\Documents\GitHub\AfroTada new website code\zimbabweBooks.html", "HTML", 75, 0, 0, 0, 0, 8, 2, 85
"c:\Users\OlabayoBalogun\Documents\GitHub\AfroTada new website code\zimbabweCulture.html", "HTML", 75, 0, 0, 0, 0, 8, 2, 85
"c:\Users\OlabayoBalogun\Documents\GitHub\AfroTada new website code\zimbabweDocumentaries.html", "HTML", 75, 0, 0, 0, 0, 8, 2, 85
"c:\Users\OlabayoBalogun\Documents\GitHub\AfroTada new website code\zimbabweFood.html", "HTML", 75, 0, 0, 0, 0, 8, 2, 85
"c:\Users\OlabayoBalogun\Documents\GitHub\AfroTada new website code\zimbabweHistoricalSites.html", "HTML", 75, 0, 0, 0, 0, 8, 2, 85
"c:\Users\OlabayoBalogun\Documents\GitHub\AfroTada new website code\zimbabweNaturalResources.html", "HTML", 75, 0, 0, 0, 0, 8, 2, 85
"c:\Users\OlabayoBalogun\Documents\GitHub\AfroTada new website code\zimbabwePodcasts.html", "HTML", 75, 0, 0, 0, 0, 8, 2, 85
"c:\Users\OlabayoBalogun\Documents\GitHub\AfroTada new website code\zimbabwePoets.html", "HTML", 75, 0, 0, 0, 0, 8, 2, 85
"c:\Users\OlabayoBalogun\Documents\GitHub\AfroTada new website code\zimbabweProverbs.html", "HTML", 75, 0, 0, 0, 0, 8, 2, 85
"c:\Users\OlabayoBalogun\Documents\GitHub\AfroTada new website code\zimbabweQuotes.html", "HTML", 75, 0, 0, 0, 0, 8, 2, 85
"c:\Users\OlabayoBalogun\Documents\GitHub\AfroTada new website code\zimbabweUniversities.html", "HTML", 75, 0, 0, 0, 0, 8, 2, 85
"c:\Users\OlabayoBalogun\Documents\GitHub\AfroTada new website code\zimbabweWriters.html", "HTML", 75, 0, 0, 0, 0, 8, 2, 85
"Total", "-", 60429, 2, 2013, 1, 39018, 7903, 10293, 119659